//MAP CONVERTED BY dmm2tgm.py THIS HEADER COMMENT PREVENTS RECONVERSION, DO NOT REMOVE
"a" = (
/turf/closed/indestructible/reinforced,
/area/city/backstreets_room)
"b" = (
/obj/structure/railing{
	dir = 4
	},
/mob/living/simple_animal/hostile/ordeal/green_bot{
	name = "clerk bot"
	},
/obj/effect/decal/cleanable/dirt/dust,
/obj/effect/decal/cleanable/dirt/dust,
/obj/effect/decal/cleanable/dirt/dust,
/turf/open/floor/mineral/plastitanium,
/area/city/backstreets_room)
"e" = (
/obj/effect/decal/cleanable/dirt/dust,
/obj/effect/decal/cleanable/dirt/dust,
/turf/open/floor/mineral/plastitanium,
/area/city/backstreets_room)
"h" = (
/obj/effect/decal/cleanable/dirt/dust,
/turf/closed/indestructible/reinforced,
/area/city/backstreets_room)
"n" = (
/obj/structure/railing{
	dir = 1
	},
/mob/living/simple_animal/hostile/ordeal/green_bot{
	name = "clerk bot"
	},
/obj/effect/decal/cleanable/dirt/dust,
/obj/effect/decal/cleanable/dirt/dust,
/turf/open/floor/mineral/plastitanium,
/area/city/backstreets_room)
"q" = (
/obj/effect/decal/cleanable/dirt/dust,
/obj/effect/decal/cleanable/dirt/dust,
/obj/effect/decal/cleanable/dirt/dust,
/obj/effect/decal/cleanable/dirt/dust,
/obj/structure/lootcrate/money,
/turf/open/floor/mineral/plastitanium,
/area/city/backstreets_room)
"v" = (
/turf/open/floor/plating/asteroid/basalt,
/area/city/backstreets_room)
"w" = (
/obj/structure/railing/corner,
/mob/living/simple_animal/hostile/ordeal/green_bot{
	name = "clerk bot"
	},
/obj/effect/decal/cleanable/dirt/dust,
/turf/open/floor/mineral/plastitanium,
/area/city/backstreets_room)
"x" = (
/obj/structure/railing/corner{
	dir = 1
	},
/mob/living/simple_animal/hostile/ordeal/green_bot{
	name = "clerk bot"
	},
/obj/effect/decal/cleanable/dirt/dust,
/obj/effect/decal/cleanable/dirt/dust,
/obj/effect/decal/cleanable/dirt/dust,
/obj/effect/decal/cleanable/dirt/dust,
/obj/effect/decal/cleanable/dirt/dust,
/turf/open/floor/mineral/plastitanium,
/area/city/backstreets_room)
"D" = (
/mob/living/simple_animal/hostile/price,
/obj/effect/decal/cleanable/dirt/dust,
/obj/effect/decal/cleanable/dirt/dust,
/obj/effect/decal/cleanable/dirt/dust,
/turf/open/floor/mineral/plastitanium/red,
/area/city/backstreets_room)
"J" = (
/obj/structure/railing/corner{
	dir = 8
	},
/mob/living/simple_animal/hostile/ordeal/green_bot{
	name = "clerk bot"
	},
/obj/effect/decal/cleanable/dirt/dust,
/turf/open/floor/plating/asteroid/basalt,
/area/city/backstreets_room)
"N" = (
/obj/structure/railing/corner{
	dir = 4
	},
/mob/living/simple_animal/hostile/ordeal/green_bot{
	name = "clerk bot"
	},
/obj/effect/decal/cleanable/dirt/dust,
/obj/effect/decal/cleanable/dirt/dust,
/obj/effect/decal/cleanable/dirt/dust,
/turf/open/floor/mineral/plastitanium,
/area/city/backstreets_room)
"R" = (
/obj/effect/decal/cleanable/dirt/dust,
/obj/effect/decal/cleanable/dirt/dust,
/obj/effect/decal/cleanable/dirt/dust,
/turf/open/floor/mineral/plastitanium,
/area/city/backstreets_room)
"S" = (
/obj/structure/railing{
	dir = 8
	},
/mob/living/simple_animal/hostile/ordeal/green_bot{
	name = "clerk bot"
	},
/obj/effect/decal/cleanable/dirt/dust,
/turf/open/floor/mineral/plastitanium,
/area/city/backstreets_room)
"T" = (
/obj/structure/railing,
/mob/living/simple_animal/hostile/ordeal/green_bot{
	name = "clerk bot"
	},
/obj/effect/decal/cleanable/dirt/dust,
/turf/open/floor/mineral/plastitanium,
/area/city/backstreets_room)
"X" = (
/obj/effect/decal/cleanable/dirt/dust,
/turf/open/floor/plating/asteroid/basalt,
/area/city/backstreets_room)

(1,1,1) = {"
a
a
a
a
a
a
a
"}
(2,1,1) = {"
a
q
w
b
N
R
h
"}
(3,1,1) = {"
a
e
T
D
n
R
a
"}
(4,1,1) = {"
a
v
J
S
x
X
a
"}
(5,1,1) = {"
a
X
v
X
v
v
a
"}
