//MAP CONVERTED BY dmm2tgm.py THIS HEADER COMMENT PREVENTS RECONVERSION, DO NOT REMOVE
"a" = (
/turf/closed/indestructible/rock,
/area/space)
"l" = (
/turf/open/floor/facility,
/area/test_range)
"m" = (
/turf/open/floor/facility/dark,
/area/test_range)
"p" = (
/obj/machinery/quantumpad/warp{
	teleport_cooldown = 40;
	map_pad_id = "test_range_arena";
	map_pad_link_id = "test_range_lobby";
	teleport_speed = 20;
	resistance_flags = 64
	},
/turf/open/floor/facility,
/area/test_range)
"s" = (
/obj/effect/light_emitter{
	light_power = 4;
	light_range = 25;
	set_cap = 3;
	set_luminosity = 24
	},
/turf/open/floor/facility,
/area/test_range)
"t" = (
/mob/living/simple_animal/bot/cleanbot,
/turf/open/floor/facility,
/area/test_range)
"z" = (
/obj/machinery/door/airlock,
/turf/open/floor/facility,
/area/test_range)
"J" = (
/turf/closed/indestructible/reinforced,
/area/test_range)
"X" = (
/obj/effect/radiojammer,
/turf/closed/indestructible/rock,
/area/space)
"Z" = (
/obj/machinery/regenerator/safety,
/turf/open/floor/facility,
/area/test_range)

(1,1,1) = {"
a
a
a
a
a
a
a
a
a
a
a
a
a
a
a
a
a
a
a
a
a
a
a
a
a
"}
(2,1,1) = {"
a
a
a
a
a
a
a
a
a
a
a
a
a
a
a
a
a
a
a
a
a
a
a
a
a
"}
(3,1,1) = {"
a
a
a
a
a
a
a
a
a
a
a
a
a
a
a
a
a
a
a
a
a
a
a
a
a
"}
(4,1,1) = {"
a
a
a
a
a
a
a
a
a
a
a
a
a
a
a
a
a
a
a
a
a
a
a
a
a
"}
(5,1,1) = {"
a
a
a
a
a
a
a
a
a
a
a
a
a
a
a
a
a
a
a
a
a
a
a
a
a
"}
(6,1,1) = {"
a
a
a
a
a
a
a
a
a
a
a
a
X
a
a
a
a
a
a
a
a
a
a
a
a
"}
(7,1,1) = {"
a
a
a
a
a
J
J
J
J
J
J
J
J
J
J
J
J
J
a
a
a
a
a
a
a
"}
(8,1,1) = {"
a
a
a
a
a
J
l
l
l
l
l
l
l
l
l
l
l
J
a
a
a
a
a
a
a
"}
(9,1,1) = {"
a
a
a
a
a
J
l
l
l
l
l
l
l
l
l
l
l
J
a
a
a
a
a
a
a
"}
(10,1,1) = {"
a
a
a
a
a
J
l
l
l
l
l
t
l
l
l
l
l
J
a
a
a
a
a
a
a
"}
(11,1,1) = {"
a
a
a
a
a
J
l
l
l
l
l
l
l
l
l
l
l
J
J
J
J
J
J
a
a
"}
(12,1,1) = {"
a
a
a
a
a
J
l
l
l
l
l
l
l
l
l
l
l
J
l
l
l
l
J
a
a
"}
(13,1,1) = {"
a
a
a
a
a
J
l
l
s
l
l
m
l
l
s
l
l
z
l
s
p
l
J
a
a
"}
(14,1,1) = {"
a
a
a
a
a
J
l
l
l
l
l
l
l
l
l
l
l
J
l
l
l
Z
J
a
a
"}
(15,1,1) = {"
a
a
a
a
a
J
l
l
l
l
l
l
l
l
l
l
l
J
J
J
J
J
J
a
a
"}
(16,1,1) = {"
a
a
a
a
a
J
l
l
l
l
l
t
l
l
l
l
l
J
a
a
a
a
a
a
a
"}
(17,1,1) = {"
a
a
a
a
a
J
l
l
l
l
l
l
l
l
l
l
l
J
a
a
a
a
a
a
a
"}
(18,1,1) = {"
a
a
a
a
a
J
l
l
l
l
l
l
l
l
l
l
l
J
a
a
a
a
a
a
a
"}
(19,1,1) = {"
a
a
a
a
a
J
J
J
J
J
J
J
J
J
J
J
J
J
a
a
a
a
a
a
a
"}
(20,1,1) = {"
a
a
a
a
a
a
a
a
a
a
a
a
a
a
a
a
a
a
a
a
a
a
a
a
a
"}
(21,1,1) = {"
a
a
a
a
a
a
a
a
a
a
a
a
a
a
a
a
a
a
a
a
a
a
a
a
a
"}
(22,1,1) = {"
a
a
a
a
a
a
a
a
a
a
a
a
a
a
a
a
a
a
a
a
a
a
a
a
a
"}
(23,1,1) = {"
a
a
a
a
a
a
a
a
a
a
a
a
a
a
a
a
a
a
a
a
a
a
a
a
a
"}
(24,1,1) = {"
a
a
a
a
a
a
a
a
a
a
a
a
a
a
a
a
a
a
a
a
a
a
a
a
a
"}
(25,1,1) = {"
a
a
a
a
a
a
a
a
a
a
a
a
a
a
a
a
a
a
a
a
a
a
a
a
a
"}
