"aF" = (/obj/machinery/door/airlock/centcom{name = "Dormitories"; req_access_txt = "150"},/obj/effect/decal/cleanable/dirt,/turf/open/floor/wood,/area/ruin/powered)
"bF" = (/obj/machinery/computer/mech_bay_power_console,/obj/effect/decal/cleanable/dirt,/turf/open/floor/plating,/area/ruin/powered)
"bH" = (/obj/effect/turf_decal/stripes/line{dir = 1},/obj/effect/decal/cleanable/dirt,/turf/open/floor/plating,/area/ruin/powered)
"ch" = (/obj/effect/decal/cleanable/dirt,/turf/open/floor/wood{icon_state = "wood-broken4"},/area/ruin/powered)
"cl" = (/obj/effect/turf_decal/tile/bar,/obj/effect/turf_decal/tile/bar{dir = 1},/obj/item/clothing/head/helmet/space/syndicate,/obj/effect/decal/cleanable/dirt,/turf/open/floor/plasteel,/area/ruin/powered)
"cn" = (/obj/structure/table,/obj/item/toy/talking/ai,/obj/effect/turf_decal/tile/red{dir = 1},/obj/effect/turf_decal/tile/red{dir = 4},/obj/effect/turf_decal/tile/red{dir = 8},/obj/effect/decal/cleanable/dirt,/turf/open/floor/plasteel/dark,/area/ruin/powered)
"dm" = (/obj/structure/table,/obj/effect/decal/cleanable/dirt,/turf/open/floor/plating,/area/ruin/powered)
"dX" = (/obj/structure/table/wood,/obj/structure/frame/machine,/obj/item/stack/cable_coil/five,/obj/item/circuitboard/machine/chem_dispenser/drinks/beer,/turf/open/floor/wood{icon_state = "wood-broken7"},/area/ruin/powered)
"eu" = (/obj/item/circuitboard/machine/mech_recharger,/obj/structure/frame/machine,/obj/item/stack/cable_coil/five,/turf/open/floor/plating,/area/ruin/powered)
"eX" = (/obj/machinery/door/airlock/centcom{name = "Air Traffic Control"; req_access_txt = "150"},/turf/open/floor/plating,/area/ruin/powered)
"fa" = (/obj/effect/spawner/structure/window/plasma/reinforced/plastitanium,/turf/open/floor/plating/airless,/area/ruin/powered)
"fL" = (/obj/effect/turf_decal/tile/bar,/obj/effect/turf_decal/tile/bar{dir = 1},/obj/machinery/vending/cigarette,/turf/open/floor/plasteel,/area/ruin/powered)
"fP" = (/obj/effect/turf_decal/stripes/line{dir = 9},/turf/open/floor/plating,/area/ruin/powered)
"gj" = (/obj/effect/turf_decal/stripes/line{dir = 1},/turf/open/floor/plating,/area/ruin/powered)
"gp" = (/turf/template_noop,/area/template_noop)
"gt" = (/obj/item/clothing/mask/gas/syndicate,/obj/item/mining_scanner,/obj/item/pickaxe,/obj/structure/closet/syndicate,/obj/item/tank/internals/emergency_oxygen/engi,/obj/item/clothing/suit/hooded/wintercoat,/obj/effect/decal/cleanable/dirt,/turf/open/floor/plating,/area/ruin/powered)
"gZ" = (/obj/effect/turf_decal/tile/bar,/obj/effect/turf_decal/tile/bar{dir = 1},/obj/structure/chair/stool,/obj/effect/spawner/lootdrop/maintenance,/turf/open/floor/plasteel,/area/ruin/powered)
"ha" = (/obj/item/reagent_containers/food/drinks/shaker,/obj/effect/decal/cleanable/dirt,/turf/open/floor/wood{icon_state = "wood-broken3"},/area/ruin/powered)
"ic" = (/obj/machinery/vending/boozeomat,/turf/open/floor/wood,/area/ruin/powered)
"ij" = (/obj/effect/decal/cleanable/dirt,/obj/effect/spawner/lootdrop/maintenance,/turf/open/floor/wood{icon_state = "wood-broken3"},/area/ruin/powered)
"iB" = (/obj/structure/table,/obj/effect/turf_decal/tile/red{dir = 1},/obj/effect/turf_decal/tile/red{dir = 4},/obj/effect/turf_decal/tile/red,/obj/effect/decal/cleanable/dirt,/turf/open/floor/plasteel/dark,/area/ruin/powered)
"iD" = (/obj/structure/closet/cardboard/metal,/obj/effect/turf_decal/stripes/corner{dir = 4},/obj/effect/decal/cleanable/dirt,/obj/effect/spawner/lootdrop/maintenance,/obj/effect/spawner/lootdrop/maintenance,/obj/effect/spawner/lootdrop/maintenance,/obj/effect/spawner/lootdrop/maintenance,/obj/effect/spawner/lootdrop/maintenance,/turf/open/floor/plating,/area/ruin/powered)
"iR" = (/obj/effect/turf_decal/stripes/line{dir = 1},/obj/effect/spawner/lootdrop/maintenance,/obj/effect/decal/cleanable/dirt,/turf/open/floor/plating,/area/ruin/powered)
"iS" = (/obj/effect/decal/cleanable/dirt,/obj/item/rack_parts,/obj/item/clothing/suit/space/syndicate,/obj/item/clothing/head/helmet/space/syndicate,/turf/open/floor/mineral/plastitanium/red,/area/ruin/powered)
"iY" = (/obj/effect/turf_decal/tile/bar,/obj/effect/turf_decal/tile/bar{dir = 1},/obj/machinery/vending/toyliberationstation,/turf/open/floor/plasteel,/area/ruin/powered)
"jp" = (/obj/effect/spawner/lootdrop/maintenance/two,/obj/structure/closet/syndicate,/obj/item/flashlight/flare,/obj/item/toy/crayon/spraycan,/obj/effect/turf_decal/box/red,/obj/effect/decal/cleanable/dirt,/turf/open/floor/plasteel/dark,/area/ruin/powered)
"jI" = (/obj/effect/turf_decal/tile/bar,/obj/effect/turf_decal/tile/bar{dir = 1},/obj/structure/table/wood,/obj/structure/table/wood,/obj/item/paicard,/obj/effect/decal/cleanable/dirt,/turf/open/floor/plasteel,/area/ruin/powered)
"jK" = (/obj/effect/turf_decal/stripes/line{dir = 1},/obj/effect/decal/cleanable/dirt,/obj/effect/spawner/lootdrop/maintenance,/turf/open/floor/plating,/area/ruin/powered)
"jX" = (/obj/structure/table/wood,/obj/structure/frame/machine,/obj/item/stack/cable_coil/five,/obj/item/circuitboard/machine/chem_dispenser/drinks,/turf/open/floor/wood{icon_state = "wood-broken7"},/area/ruin/powered)
"ke" = (/obj/structure/table/wood,/obj/item/storage/box/syndie_kit/sleepytime,/obj/machinery/light{dir = 4},/turf/open/floor/wood,/area/ruin/powered)
"kj" = (/obj/item/shard{icon_state = "tiny"},/obj/item/shard{icon_state = "small"; pixel_x = 6; pixel_y = 5},/obj/item/stack/cable_coil/five,/obj/item/shard{pixel_x = -4; pixel_y = 3},/obj/effect/decal/cleanable/dirt,/turf/open/floor/wood,/area/ruin/powered)
"kS" = (/obj/effect/spawner/lootdrop/maintenance/two,/obj/structure/closet/syndicate,/obj/item/megaphone/sec{name = "syndicate megaphone"},/obj/item/toy/sword,/obj/item/toy/sword,/obj/effect/turf_decal/box/red,/obj/effect/decal/cleanable/dirt,/turf/open/floor/plasteel/dark,/area/ruin/powered)
"kT" = (/obj/structure/door_assembly/door_assembly_centcom,/turf/open/floor/plating,/area/ruin/powered)
"lw" = (/obj/effect/spawner/lootdrop/maintenance,/obj/effect/decal/cleanable/dirt,/turf/open/floor/plating,/area/ruin/powered)
"lN" = (/obj/effect/decal/cleanable/dirt,/obj/structure/light_construct,/turf/open/floor/plasteel/dark,/area/ruin/powered)
"mc" = (/obj/effect/decal/cleanable/dirt,/obj/structure/rack,/turf/open/floor/plating,/area/ruin/powered)
"mz" = (/obj/item/toy/cards/deck/syndicate{pixel_x = -6; pixel_y = 6},/obj/structure/table_frame/wood,/obj/effect/spawner/lootdrop/maintenance,/turf/open/floor/plating,/area/ruin/powered)
"mE" = (/obj/effect/spawner/lootdrop/maintenance,/turf/open/floor/plating,/area/ruin/powered)
"nm" = (/obj/effect/turf_decal/stripes/corner{dir = 8},/obj/effect/decal/cleanable/dirt,/obj/effect/spawner/lootdrop/maintenance,/turf/open/floor/plating,/area/ruin/powered)
"ok" = (/obj/structure/table/wood,/obj/item/radio{icon_state = "radio"},/turf/open/floor/wood{icon_state = "wood-broken6"},/area/ruin/powered)
"ot" = (/obj/structure/toilet{dir = 8},/obj/structure/window/reinforced/tinted{dir = 1},/obj/machinery/door/window{dir = 8; icon_state = "right"; name = "Tactical Toilet"; opacity = 1},/turf/open/floor/plasteel/freezer,/area/ruin/powered)
"oU" = (/obj/effect/spawner/lootdrop/maintenance,/obj/effect/decal/cleanable/dirt,/turf/open/floor/plasteel/dark,/area/ruin/powered)
"ps" = (/obj/effect/decal/cleanable/dirt,/obj/effect/spawner/lootdrop/maintenance,/turf/open/floor/wood,/area/ruin/powered)
"pW" = (/obj/machinery/vending/tool,/obj/effect/decal/cleanable/dirt,/turf/open/floor/plasteel/dark,/area/ruin/powered)
"qi" = (/obj/structure/frame/computer,/obj/effect/turf_decal/tile/red{dir = 1},/obj/effect/turf_decal/tile/red{dir = 4},/obj/effect/decal/cleanable/dirt,/turf/open/floor/plasteel/dark,/area/ruin/powered)
"qt" = (/obj/effect/decal/cleanable/dirt,/obj/effect/decal/cleanable/dirt,/turf/open/floor/wood,/area/ruin/powered)
"rv" = (/turf/open/floor/plating/asteroid/snow/icemoon,/area/template_noop)
"rG" = (/turf/open/floor/plating/asteroid/snow/icemoon,/area/icemoon/underground/unexplored)
"sf" = (/obj/effect/turf_decal/tile/bar,/obj/effect/turf_decal/tile/bar{dir = 1},/obj/structure/table/wood,/obj/item/chair/stool,/obj/effect/gibspawner/human,/obj/item/disk/nuclear/fake,/turf/open/floor/plasteel,/area/ruin/powered)
"so" = (/obj/effect/decal/cleanable/dirt,/obj/effect/spawner/lootdrop/maintenance,/turf/open/floor/wood{icon_state = "wood-broken5"},/area/ruin/powered)
"sW" = (/obj/effect/turf_decal/tile/bar,/obj/effect/turf_decal/tile/bar{dir = 1},/obj/effect/gibspawner/human,/obj/effect/spawner/lootdrop/maintenance,/obj/effect/decal/cleanable/dirt,/turf/open/floor/plasteel,/area/ruin/powered)
"tg" = (/obj/structure/table_frame/wood,/obj/effect/decal/cleanable/dirt,/turf/open/floor/wood{icon_state = "wood-broken5"},/area/ruin/powered)
"tr" = (/obj/machinery/washing_machine,/obj/effect/decal/cleanable/dirt,/turf/open/floor/plasteel/freezer,/area/ruin/powered)
"tt" = (/obj/item/toy/nuke,/obj/effect/decal/cleanable/dirt,/turf/open/floor/wood,/area/ruin/powered)
"tP" = (/obj/effect/turf_decal/tile/bar,/obj/effect/turf_decal/tile/bar{dir = 1},/obj/structure/frame/computer,/obj/item/shard{icon_state = "tiny"},/obj/item/shard{pixel_x = -6; pixel_y = -5},/obj/item/shard{icon_state = "medium"},/turf/open/floor/plasteel,/area/ruin/powered)
"tS" = (/obj/effect/decal/cleanable/dirt,/obj/effect/decal/cleanable/dirt,/turf/open/floor/plating,/area/ruin/powered)
"ud" = (/obj/effect/turf_decal/tile/bar,/obj/effect/turf_decal/tile/bar{dir = 1},/obj/item/kirbyplants/random,/obj/effect/decal/cleanable/dirt,/turf/open/floor/plasteel,/area/ruin/powered)
"ux" = (/obj/item/chair/stool,/obj/effect/spawner/lootdrop/maintenance,/obj/effect/decal/cleanable/dirt,/turf/open/floor/plasteel/dark,/area/ruin/powered)
"vk" = (/obj/effect/turf_decal/stripes/line{dir = 1},/obj/structure/table,/obj/effect/decal/cleanable/dirt,/turf/open/floor/mineral/plastitanium/red,/area/ruin/powered)
"vw" = (/obj/structure/bed,/obj/item/bedsheet/syndie{layer = 3},/turf/open/floor/wood{icon_state = "wood-broken7"},/area/ruin/powered)
"vH" = (/obj/item/storage/box/syndie_kit/sleepytime,/obj/effect/decal/cleanable/dirt,/turf/open/floor/wood,/area/ruin/powered)
"vV" = (/turf/closed/wall/mineral/plastitanium/nodiagonal,/area/ruin/powered)
"wO" = (/obj/structure/closet/syndicate,/obj/effect/spawner/lootdrop/maintenance/two,/obj/item/card/id/syndicate/anyone,/turf/open/floor/plating,/area/ruin/powered)
"xa" = (/obj/structure/frame/computer,/turf/open/floor/plating/airless,/area/ruin/powered)
"xn" = (/obj/machinery/door/airlock/external,/obj/effect/decal/cleanable/dirt,/turf/open/floor/plating,/area/ruin/powered)
"xA" = (/obj/structure/chair/office{dir = 1},/obj/effect/decal/cleanable/dirt,/turf/open/floor/plasteel/dark,/area/ruin/powered)
"xB" = (/obj/effect/turf_decal/stripes/line{dir = 1},/obj/structure/closet/syndicate,/obj/effect/decal/cleanable/dirt,/turf/open/floor/mineral/plastitanium/red,/area/ruin/powered)
"yB" = (/obj/effect/turf_decal/stripes/corner,/obj/effect/decal/cleanable/dirt,/turf/open/floor/plating,/area/ruin/powered)
"yO" = (/obj/effect/decal/cleanable/dirt,/turf/open/floor/wood{icon_state = "wood-broken3"},/area/ruin/powered)
"yW" = (/obj/effect/decal/cleanable/dirt,/obj/effect/decal/cleanable/dirt,/turf/open/floor/wood{icon_state = "wood-broken"},/area/ruin/powered)
"zj" = (/obj/structure/sink{dir = 8; pixel_x = 11},/obj/effect/decal/cleanable/dirt,/obj/effect/decal/cleanable/dirt,/turf/open/floor/plating,/area/ruin/powered)
"zI" = (/obj/structure/frame/computer,/obj/effect/turf_decal/tile/red{dir = 1},/obj/effect/turf_decal/tile/red{dir = 4},/turf/open/floor/plasteel/dark,/area/ruin/powered)
"zL" = (/obj/structure/girder,/obj/effect/decal/cleanable/dirt,/turf/open/floor/plating,/area/ruin/powered)
"zU" = (/obj/structure/mirror{pixel_x = 28},/obj/effect/decal/cleanable/dirt,/turf/open/floor/plasteel/freezer,/area/ruin/powered)
"Ai" = (/obj/machinery/button/door/indestructible{id = "abandonednewcopshuttle"; name = "mission launch control"; pixel_x = -26},/obj/effect/turf_decal/tile/bar,/obj/effect/turf_decal/tile/bar{dir = 1},/obj/effect/decal/cleanable/dirt,/obj/item/broken_bottle,/turf/open/floor/plasteel,/area/ruin/powered)
"AE" = (/obj/effect/turf_decal/stripes/line{dir = 1},/obj/effect/spawner/lootdrop/maintenance,/turf/open/floor/plating,/area/ruin/powered)
"AW" = (/obj/effect/turf_decal/tile/bar,/obj/effect/turf_decal/tile/bar{dir = 1},/obj/structure/chair/stool,/obj/effect/decal/cleanable/dirt,/turf/open/floor/plasteel,/area/ruin/powered)
"Bd" = (/obj/structure/marker_beacon/burgundy,/turf/open/floor/plating/asteroid/snow/icemoon,/area/icemoon/underground/unexplored)
"Bo" = (/obj/item/documents/syndicate,/obj/item/clothing/gloves/krav_maga/combatglovesplus,/obj/structure/safe,/turf/open/floor/wood,/area/ruin/powered)
"Br" = (/obj/effect/turf_decal/stripes/line{dir = 10},/obj/effect/decal/cleanable/dirt,/turf/open/floor/plating,/area/ruin/powered)
"BS" = (/obj/effect/turf_decal/stripes/line{dir = 5},/obj/effect/decal/cleanable/dirt,/turf/open/floor/plating,/area/ruin/powered)
"Cd" = (/obj/structure/girder,/turf/open/floor/plating,/area/ruin/powered)
"Cs" = (/obj/effect/decal/cleanable/dirt,/turf/open/floor/wood,/area/ruin/powered)
"CU" = (/obj/effect/turf_decal/stripes/line{dir = 4},/turf/open/floor/plating,/area/ruin/powered)
"CV" = (/obj/effect/turf_decal/stripes/corner{dir = 4},/turf/open/floor/plating,/area/ruin/powered)
"Di" = (/obj/effect/decal/cleanable/dirt,/obj/effect/spawner/lootdrop/maintenance,/turf/open/floor/plating,/area/ruin/powered)
"Ds" = (/turf/closed/wall/mineral/plastitanium,/area/ruin/powered)
"Dv" = (/obj/effect/turf_decal/stripes/corner{dir = 8},/obj/effect/decal/cleanable/dirt,/turf/open/floor/plating,/area/ruin/powered)
"DG" = (/obj/structure/urinal{pixel_y = 28},/obj/effect/decal/cleanable/dirt,/turf/open/floor/plasteel/freezer,/area/ruin/powered)
"Ec" = (/obj/machinery/door/poddoor/shuttledock{id = abandonednukebase; name = stolen shuttle storage},/turf/open/floor/plating,/area/ruin/powered)
"Ez" = (/obj/effect/turf_decal/tile/bar,/obj/effect/turf_decal/tile/bar{dir = 1},/obj/item/broken_bottle{pixel_x = 3; pixel_y = 5},/obj/item/shard,/obj/effect/decal/cleanable/dirt,/turf/open/floor/plasteel,/area/ruin/powered)
"EV" = (/obj/machinery/light/small{brightness = 3; dir = 8},/obj/effect/decal/cleanable/dirt,/turf/open/floor/plasteel/freezer,/area/ruin/powered)
"Fb" = (/obj/structure/closet/syndicate,/obj/item/clothing/shoes/jackboots,/obj/item/clothing/glasses/night,/obj/item/radio/headset,/obj/item/kitchen/knife/combat/survival,/obj/item/radio{icon_state = "radio"},/obj/effect/decal/cleanable/dirt,/obj/item/clothing/under/color/black,/turf/open/floor/wood,/area/ruin/powered)
"Fh" = (/obj/machinery/door/airlock/centcom{name = "Auxiliary Dock"; req_access_txt = ""},/turf/open/floor/plating,/area/ruin/powered)
"Fo" = (/obj/effect/turf_decal/stripes/line{dir = 8},/obj/effect/decal/cleanable/dirt,/turf/open/floor/plating,/area/ruin/powered)
"Fr" = (/obj/effect/spawner/structure/window/plasma/reinforced/plastitanium,/turf/open/floor/plating,/area/ruin/powered)
"FL" = (/obj/structure/flora/bush,/turf/open/floor/plating/asteroid/snow/icemoon,/area/icemoon/underground/unexplored)
"GU" = (/obj/effect/turf_decal/tile/bar,/obj/effect/turf_decal/tile/bar{dir = 1},/obj/item/paper/fluff/stations/centcom/disk_memo,/obj/effect/spawner/lootdrop/maintenance,/obj/effect/decal/cleanable/dirt,/turf/open/floor/plasteel,/area/ruin/powered)
"Ha" = (/obj/effect/turf_decal/stripes/line{dir = 6},/turf/open/floor/plating,/area/ruin/powered)
"Hy" = (/obj/effect/turf_decal/tile/bar,/obj/effect/turf_decal/tile/bar{dir = 1},/obj/machinery/light{dir = 8},/obj/effect/decal/cleanable/dirt,/turf/open/floor/plasteel,/area/ruin/powered)
"HB" = (/obj/effect/turf_decal/tile/bar,/obj/effect/turf_decal/tile/bar{dir = 1},/obj/effect/decal/cleanable/dirt,/obj/effect/gibspawner/human,/turf/open/floor/plasteel,/area/ruin/powered)
"IG" = (/obj/effect/turf_decal/stripes/line,/obj/effect/decal/cleanable/dirt,/turf/open/floor/plating,/area/ruin/powered)
"Je" = (/obj/effect/turf_decal/tile/bar,/obj/effect/turf_decal/tile/bar{dir = 1},/obj/effect/decal/cleanable/dirt,/turf/open/floor/plasteel,/area/ruin/powered)
"JE" = (/obj/effect/decal/cleanable/dirt,/turf/open/floor/wood{icon_state = "wood-broken6"},/area/ruin/powered)
"JN" = (/obj/effect/turf_decal/stripes/line{dir = 1},/obj/structure/closet/syndicate,/obj/effect/decal/cleanable/dirt,/obj/effect/spawner/lootdrop/maintenance/two,/turf/open/floor/mineral/plastitanium/red,/area/ruin/powered)
"Kk" = (/obj/effect/turf_decal/stripes/line{dir = 1},/obj/structure/closet/syndicate,/obj/effect/decal/cleanable/dirt,/obj/effect/spawner/lootdrop/maintenance/two,/obj/item/ammo_box/magazine/m9mm,/turf/open/floor/mineral/plastitanium/red,/area/ruin/powered)
"Ko" = (/obj/effect/turf_decal/stripes/line{dir = 8},/turf/open/floor/plating,/area/ruin/powered)
"Kx" = (/obj/item/soap/syndie,/obj/machinery/light/small{dir = 1},/obj/effect/decal/cleanable/dirt,/turf/open/floor/plating,/area/ruin/powered)
"KJ" = (/obj/effect/turf_decal/stripes/line{dir = 4},/obj/effect/decal/cleanable/dirt,/turf/open/floor/plating,/area/ruin/powered)
"KN" = (/obj/structure/table/wood,/obj/item/toy/plush/nukeplushie,/obj/effect/decal/cleanable/dirt,/turf/open/floor/wood,/area/ruin/powered)
"KZ" = (/obj/effect/turf_decal/tile/bar,/obj/effect/turf_decal/tile/bar{dir = 1},/obj/effect/decal/cleanable/dirt,/obj/effect/spawner/lootdrop/maintenance,/turf/open/floor/plasteel,/area/ruin/powered)
"Lh" = (/obj/item/bedsheet/syndie,/obj/structure/bed,/obj/effect/decal/cleanable/dirt,/turf/open/floor/wood,/area/ruin/powered)
"Lq" = (/obj/structure/girder,/turf/open/floor/plating/airless,/area/ruin/powered)
"Lt" = (/obj/structure/light_construct,/obj/effect/decal/cleanable/dirt,/turf/open/floor/wood{icon_state = "wood-broken"},/area/ruin/powered)
"LA" = (/obj/structure/rack,/obj/item/clothing/suit/space/syndicate,/turf/open/floor/mineral/plastitanium/red,/area/ruin/powered)
"LL" = (/obj/effect/decal/cleanable/dirt,/obj/effect/spawner/lootdrop/maintenance,/turf/open/floor/plasteel/dark,/area/ruin/powered)
"LP" = (/obj/effect/decal/cleanable/dirt,/turf/open/floor/plating,/area/ruin/powered)
"LU" = (/obj/effect/turf_decal/tile/bar,/obj/effect/turf_decal/tile/bar{dir = 1},/turf/open/floor/plasteel,/area/ruin/powered)
"Ml" = (/obj/structure/closet/syndicate,/obj/item/toy/figure/syndie,/obj/effect/decal/cleanable/dirt,/turf/open/floor/plating,/area/ruin/powered)
"PH" = (/obj/machinery/door/airlock/centcom{name = "Dormitories"; req_access_txt = "150"},/obj/effect/decal/cleanable/dirt,/obj/effect/decal/cleanable/dirt,/turf/open/floor/wood{icon_state = "wood-broken4"},/area/ruin/powered)
"Qb" = (/obj/structure/closet/syndicate,/obj/item/tank/internals/emergency_oxygen/engi,/obj/item/clothing/suit/hooded/wintercoat,/turf/open/floor/plating,/area/ruin/powered)
"Qf" = (/obj/effect/turf_decal/tile/bar,/obj/effect/turf_decal/tile/bar{dir = 1},/obj/item/chair/stool,/obj/effect/decal/cleanable/dirt,/turf/open/floor/plasteel,/area/ruin/powered)
"QT" = (/obj/effect/turf_decal/tile/bar,/obj/effect/turf_decal/tile/bar{dir = 1},/obj/machinery/vending/coffee,/turf/open/floor/plasteel,/area/ruin/powered)
"Rj" = (/obj/machinery/door/poddoor/shutters{id = "abandonednewcopshuttle"; name = "shuttle dock"},/turf/open/floor/plating,/area/ruin/powered)
"Ro" = (/obj/structure/table/wood,/obj/item/storage/box/syndie_kit/sleepytime,/turf/open/floor/wood,/area/ruin/powered)
"Rx" = (/obj/machinery/door/airlock/centcom{name = "Dormitories"; req_access_txt = "150"},/obj/effect/decal/cleanable/dirt,/turf/open/floor/wood{icon_state = "wood-broken5"},/area/ruin/powered)
"Si" = (/obj/structure/table/wood,/obj/item/storage/box/drinkingglasses,/obj/item/shard{icon_state = "small"},/turf/open/floor/wood,/area/ruin/powered)
"Ss" = (/obj/effect/turf_decal/stripes/line,/obj/machinery/light{dir = 1},/obj/effect/decal/cleanable/dirt,/turf/open/floor/plating,/area/ruin/powered)
"SN" = (/obj/structure/table/wood,/obj/item/storage/box/syndie_kit/sleepytime,/obj/machinery/light{dir = 8},/turf/open/floor/wood{icon_state = "wood-broken6"},/area/ruin/powered)
"SQ" = (/obj/machinery/vending/cola,/turf/open/floor/plating,/area/ruin/powered)
"Uf" = (/obj/item/bedsheet/syndie,/obj/structure/bed,/turf/open/floor/wood{icon_state = "wood-broken7"},/area/ruin/powered)
"Ut" = (/obj/item/chair/stool,/obj/effect/decal/cleanable/dirt,/turf/open/floor/plating,/area/ruin/powered)
"VK" = (/obj/structure/table/wood,/obj/item/chair/stool,/obj/item/storage/photo_album/syndicate{pixel_x = 4; pixel_y = 4},/obj/item/camera{pixel_x = -2},/turf/open/floor/wood,/area/ruin/powered)
"VM" = (/obj/effect/turf_decal/stripes/line{dir = 1},/obj/machinery/light,/obj/effect/decal/cleanable/dirt,/turf/open/floor/plating,/area/ruin/powered)
"VT" = (/obj/effect/turf_decal/tile/bar,/obj/effect/turf_decal/tile/bar{dir = 1},/obj/structure/bed/dogbed/cayenne,/obj/effect/decal/cleanable/dirt,/turf/open/floor/plasteel,/area/ruin/powered)
"Wp" = (/obj/effect/decal/cleanable/dirt,/mob/living/simple_animal/hostile/syndicate/ranged/shotgun/space,/turf/open/floor/plasteel/freezer,/area/ruin/powered)
"Ws" = (/obj/item/clothing/mask/gas/syndicate,/obj/item/mining_scanner,/obj/item/pickaxe,/obj/structure/closet/syndicate,/obj/item/tank/internals/emergency_oxygen/engi,/obj/item/clothing/suit/hooded/wintercoat,/obj/effect/decal/cleanable/dirt,/obj/machinery/light{dir = 1},/turf/open/floor/plasteel/dark,/area/ruin/powered)
"Wt" = (/turf/open/floor/plating,/area/ruin/powered)
"WE" = (/obj/machinery/door/airlock/centcom{name = "Dormitories"; req_access_txt = "150"},/turf/open/floor/plating,/area/ruin/powered)
"WI" = (/obj/effect/decal/cleanable/dirt,/turf/open/floor/wood{icon_state = "wood-broken"},/area/ruin/powered)
"WM" = (/obj/machinery/door/airlock/external,/turf/open/floor/plating,/area/ruin/powered)
"WV" = (/obj/structure/flora/grass/both,/turf/open/floor/plating/asteroid/snow/icemoon,/area/icemoon/underground/unexplored)
"WW" = (/obj/effect/decal/cleanable/dirt,/obj/effect/decal/cleanable/dirt,/obj/effect/spawner/lootdrop/maintenance,/turf/open/floor/wood,/area/ruin/powered)
"WY" = (/obj/effect/turf_decal/stripes/line{dir = 8},/obj/effect/decal/cleanable/dirt,/turf/open/floor/plasteel/dark,/area/ruin/powered)
"Xk" = (/obj/effect/turf_decal/tile/bar,/obj/effect/turf_decal/tile/bar{dir = 1},/obj/structure/light_construct{dir = 4},/obj/effect/decal/cleanable/dirt,/turf/open/floor/plasteel,/area/ruin/powered)
"Xn" = (/obj/structure/flora/tree/pine,/turf/open/floor/plating/asteroid/snow/icemoon,/area/icemoon/underground/unexplored)
"XN" = (/obj/machinery/light,/obj/effect/decal/cleanable/dirt,/turf/open/floor/plating,/area/ruin/powered)
"YJ" = (/obj/machinery/door/airlock/centcom{name = "Restroom"; req_access_txt = "150"},/turf/open/floor/plasteel,/area/ruin/powered)
"YQ" = (/obj/effect/turf_decal/stripes/corner{dir = 1},/turf/open/floor/plating,/area/ruin/powered)
"YU" = (/obj/structure/mecha_wreckage/mauler,/obj/machinery/light{dir = 1},/turf/open/floor/plating{icon_state = "platingdmg1"},/area/ruin/powered)
"Zc" = (/obj/structure/closet/cardboard,/obj/effect/turf_decal/stripes/corner,/obj/effect/spawner/lootdrop/maintenance,/obj/effect/spawner/lootdrop/maintenance,/obj/effect/spawner/lootdrop/maintenance,/obj/effect/spawner/lootdrop/maintenance,/obj/effect/spawner/lootdrop/maintenance,/turf/open/floor/plating,/area/ruin/powered)
"Zk" = (/obj/item/bedsheet/syndie,/obj/structure/bed,/turf/open/floor/wood,/area/ruin/powered)
"Zp" = (/turf/closed/wall/mineral/plastitanium/nodiagonal,/area/icemoon/underground/unexplored)
"ZL" = (/obj/machinery/door/airlock/centcom{name = "EVA Equipment"; req_access_txt = "150"},/turf/open/floor/plating,/area/ruin/powered)
"ZN" = (/obj/effect/turf_decal/tile/bar,/obj/effect/turf_decal/tile/bar{dir = 1},/obj/machinery/light,/obj/effect/decal/cleanable/dirt,/turf/open/floor/plasteel,/area/ruin/powered)
"ZU" = (/obj/effect/decal/cleanable/dirt,/turf/open/floor/plasteel/dark,/area/ruin/powered)
"ZZ" = (/obj/effect/turf_decal/tile/bar,/obj/effect/turf_decal/tile/bar{dir = 1},/obj/structure/table/wood,/obj/item/storage/crayons{pixel_x = -2; pixel_y = 5},/obj/item/storage/crayons{pixel_x = 2; pixel_y = 5},/obj/item/pizzabox/bomb,/turf/open/floor/plasteel,/area/ruin/powered)

(1,1,1) = {"
gpgpgpgpgpgpgpgpgpgpvVEcEcEcEcEcEcEcEcEcEcEcEcEcvVgpgpgpgpgpgpgpgpgpgpgpgp
gpgpgpgpgpgpgpgpgpgpvVbHbHbHbHiRbHiRbHbHjKbHbHbHvVgpgpgpgpgpgpgpgpgpgpgpgp
gpgpgpgpgpgpgpgpgprGvVLPlwLPXNLPLPLPLPLPXNLPLPLPvVgpgpgpgpgpgpgpgpgpgpgpgp
gpgpgpgpgpgpgpgpgprGvVvVvVvVvVvVCdLPvVvVvVvVvVvVvVgpgpgpgpgpgpgpgpgpgpgpgp
gpgpgpgpgpgpgpgpgpXnrGrGFLrGrGrGvVLPvVrGrGrGWVrGrGrGgpgpgpgpgpgpgpgpgpgpgp
gpgpgpgpgpgpgpgpgprGrGrGFLrGrGXnFrLPFrWVXnrGrGXnrGrGrGgpgpgpgpgpgpgpgpgpgp
gpgpgpgpgpgpgpgprGFLrGrGrGrGrGrGFrLPFrrGrGXnrGrGWVrGrGrvgpgpgpgpgpgpgpgpgp
gpgpgpgpgpgpgpgprGrGrGWVrGrGXnrGFrLPFrXnrGrGWVrGrGXnrGXnrGgpgpgpgpgpgpgpgp
gpgpgpgpgpgpgpgprGWVrGWVrGrGrGrGvVLPvVrGrGrGrGXnrGrGWVrGrGrGvVfafafafafavV
BdrGBdrGBdrGBdrGBdrGrGrGrGWVrGrGvVLPCdWVrGWVrGrGWVrGrGrGWVrGvVcnzIxaqiiBvV
rGrGrGrGrGrGrGrGrGrGFLXnrGrGrGrGvVLPvVrGrGrGXnrGrGXnrGrGrGXnfadmxADixAdmfa
BdrGrGrGrGrGrGrGBdrGrGrGrGFLrGrGvVWtvVrGXnrGrGXnrGrGrGXnrGrGfajpLPZUZUkSfa
rGrGrGrGrGrGrGrGrGrGrGrGrGvVFrFrCdFhvVWVrGrGrGWVrGrGXnrGrGWVfaZUZULPLPZUfa
BdrGrGrGrGrGrGrGBdWVrGXnvVvVfLlwJeXkCdvVvVvVvVFrvVrGrGrGrGrGvVLPlwZUZULPvV
rGrGrGrGrGrGrGrGrGrGrGrGvVtPLPLPGUlwQTSQvVDsKxtrvVrGrGXnrGrGvVWtZULPlNLPvV
BdrGrGrGrGrGrGrGBdrGWVrGvVUtJeAWLPJesWKZCdDGtSzUvVvVvVvVvVvVvVCdCdeXvVvVvV
rGrGrGrGrGrGrGrGrGrGrGrGvVHymEjIZZJeLPJeYJLPWpzjvVvVWtLPyBIGSsIGIGIGnmLPEc
BdrGrGrGrGrGrGrGBdFrFrFrvVLUAWsfmzclQfiYvVEVotvVLqvVLPZcHaLPlwLPLPLPBrDvEc
rGrGrGrGrGrGrGrGrGxnLPWMRjLPLPJeEzLPJeLPCdvVCdCdvVLqWtKJLPLPWtLPLPmELPFoEc
BdrGrGrGrGrGrGrGBdFrFrFrvVAiAWUtgZVTJeJeudFrFrFrFrFrFrFrWtLPDiLPLPLPLPKoEc
rGrGrGrGrGrGrGrGrGrGrGrGvVSiKNtgokVKLPlwJeWMWtLPDiWtWtWMmELPLPLPlwLPLPFoEc
BdrGrGrGrGrGrGrGBdXnrGrGvVLthaCsttkjJeHBZNFrFrFrFrFrFrFrWtLPLPLPLPLPLPKoEc
rGrGrGrGrGrGrGrGrGWVrGrGZpvVtgicjXdXCdkTCdCdvVCdvVvVWtCUWtLPlwLPWtLPDiKoEc
BdrGrGrGrGrGrGrGBdrGrGrGXnvVvVvVvVvVvVZULPeuYUbFpWvVWtiDBSWtLPLPWtWtfPYQEc
rGrGrGrGrGrGrGrGrGrGWVrGrGvViSQbWsgtFrLPoULPLLoUDivVLPLPCVbHVMbHAEgjYQLPEc
BdrGBdrGBdrGBdrGBdrGrGrGrGFrmcWYlwLPZLZUZULPZULPuxvVvVvVvVWEvVCdvVCdvVvVvV
gpgpgpgpgpgpgprGrGXnrGrGWVvVLAWYLPLLCdxBMlKkJNwOvkCdUfkeDsWWqtzLRoZkvVgpgp
gpgpgpgpgpgpgpgprGrGrGWVrGvVvVvVvVvVvVvVFrFrFrFrvVvVyOCsPHpssoaFWICsvVgpgp
gpgpgpgpgpgpgpgpgpgprGrGrGXnrGrGrGWVrGrGrGrGrGrGrGvVCdvVvVijCszLvVvVvVgpgp
gpgpgpgpgpgpgpgpgpgpgpgpgpgpgpgpgpgprGXnrGrGrGWVXnvVyWvHaFchpsRxCsJEvVgpgp
gpgpgpgpgpgpgpgpgpgpgpgpgpgpgpgpgpgpgpgpgpgpgpgpgpvVLhBovVFbFbvVSNvwvVgpgp
gpgpgpgpgpgpgpgpgpgpgpgpgpgpgpgpgpgpgpgpgpgpgpgpgpvVvVvVvVfafavVvVvVvVgpgp
"}
