//MAP CONVERTED BY dmm2tgm.py THIS HEADER COMMENT PREVENTS RECONVERSION, DO NOT REMOVE
"a" = (
/obj/structure/flora/ash/leaf_shroom,
/turf/open/floor/plating/asteroid/basalt,
/area/city/backstreets_room)
"t" = (
/obj/structure/flora/rock,
/turf/open/floor/plating/asteroid/basalt,
/area/city/backstreets_room)
"v" = (
/obj/structure/flora/ash/cacti,
/turf/open/floor/plating/asteroid/basalt,
/area/city/backstreets_room)
"x" = (
/obj/effect/spawner/structure/window/plasma/reinforced,
/obj/effect/mine/explosive,
/turf/open/floor/plating/asteroid/basalt,
/area/city/backstreets_room)
"G" = (
/obj/structure/flora/rock/pile,
/turf/open/floor/plating/asteroid/basalt,
/area/city/backstreets_room)
"M" = (
/turf/open/floor/plating/asteroid/basalt,
/area/city/backstreets_room)
"P" = (
/obj/effect/spawner/structure/window/reinforced,
/turf/open/floor/plating/asteroid/basalt,
/area/city/backstreets_room)
"R" = (
/turf/closed/mineral/ash_rock,
/area/city/backstreets_room)
"U" = (
/turf/closed/indestructible/reinforced,
/area/city/backstreets_room)
"X" = (
/obj/effect/turf_decal/plaque{
	desc = "Behold, a strange creature taken from the outskirts!"
	},
/turf/closed/indestructible/reinforced,
/area/city/backstreets_room)
"Z" = (
/obj/structure/ash_walker_eggshell,
/turf/open/floor/plating/asteroid/basalt,
/area/city/backstreets_room)

(1,1,1) = {"
U
U
U
X
U
"}
(2,1,1) = {"
R
v
G
x
P
"}
(3,1,1) = {"
R
M
M
x
P
"}
(4,1,1) = {"
R
Z
M
x
P
"}
(5,1,1) = {"
R
M
M
x
P
"}
(6,1,1) = {"
R
t
a
x
P
"}
(7,1,1) = {"
U
U
U
X
U
"}
