//MAP CONVERTED BY dmm2tgm.py THIS HEADER COMMENT PREVENTS RECONVERSION, DO NOT REMOVE
"a" = (
/obj/item/stack/sheet/bone{
	desc = "Looks to be for dog usage.";
	name = "chewed bones"
	},
/obj/effect/decal/cleanable/dirt/dust,
/obj/effect/decal/cleanable/dirt/dust,
/mob/living/simple_animal/hostile/humanoid/rat/zippy,
/turf/open/floor/carpet/blue,
/area/city/backstreets_room)
"f" = (
/obj/item/stack/sheet/bone{
	desc = "Looks to be for dog usage.";
	name = "chewed bones"
	},
/obj/effect/decal/cleanable/dirt/dust,
/obj/effect/decal/cleanable/dirt/dust,
/obj/effect/decal/cleanable/dirt/dust,
/turf/open/floor/carpet/blue,
/area/city/backstreets_room)
"n" = (
/obj/structure/railing,
/obj/effect/decal/cleanable/dirt/dust,
/obj/effect/decal/cleanable/dirt/dust,
/obj/structure/lootcrate/money,
/turf/open/floor/wood,
/area/city/backstreets_room)
"t" = (
/obj/structure/railing,
/mob/living/simple_animal/pet/dog/corgi/exoticcorgi,
/obj/effect/decal/cleanable/dirt/dust,
/obj/effect/decal/cleanable/dirt/dust,
/turf/open/floor/wood,
/area/city/backstreets_room)
"u" = (
/obj/effect/decal/cleanable/dirt/dust,
/obj/effect/decal/cleanable/dirt/dust,
/turf/open/floor/carpet/blue,
/area/city/backstreets_room)
"x" = (
/obj/effect/decal/cleanable/dirt/dust,
/obj/effect/decal/cleanable/dirt/dust,
/obj/effect/decal/cleanable/dirt/dust,
/obj/effect/decal/cleanable/dirt/dust,
/mob/living/simple_animal/hostile/humanoid/rat/zippy,
/turf/open/floor/carpet/blue,
/area/city/backstreets_room)
"B" = (
/obj/machinery/light{
	dir = 4
	},
/obj/effect/decal/cleanable/dirt/dust,
/obj/effect/decal/cleanable/dirt/dust,
/obj/effect/decal/cleanable/dirt/dust,
/mob/living/simple_animal/hostile/humanoid/rat/pipe,
/turf/open/floor/carpet/blue,
/area/city/backstreets_room)
"C" = (
/obj/structure/railing,
/obj/effect/decal/cleanable/dirt/dust,
/obj/effect/decal/cleanable/dirt/dust,
/obj/effect/decal/cleanable/dirt/dust,
/obj/effect/decal/cleanable/dirt/dust,
/mob/living/simple_animal/pet/dog/corgi/puppy/void,
/turf/open/floor/wood,
/area/city/backstreets_room)
"D" = (
/obj/structure/railing,
/mob/living/simple_animal/hostile/retaliate/tegu,
/obj/effect/decal/cleanable/dirt/dust,
/obj/effect/decal/cleanable/dirt/dust,
/turf/open/floor/wood,
/area/city/backstreets_room)
"M" = (
/obj/structure/railing,
/mob/living/simple_animal/pet/dog/corgi/ian,
/obj/item/stack/sheet/bone{
	desc = "Looks to be for dog usage.";
	name = "chewed bones"
	},
/obj/effect/decal/cleanable/dirt/dust,
/obj/effect/decal/cleanable/dirt/dust,
/obj/effect/decal/cleanable/dirt/dust,
/obj/effect/decal/cleanable/dirt/dust,
/turf/open/floor/wood,
/area/city/backstreets_room)
"P" = (
/obj/machinery/door/airlock/glass,
/obj/effect/decal/cleanable/dirt/dust,
/obj/effect/decal/cleanable/dirt/dust,
/obj/effect/decal/cleanable/dirt/dust,
/turf/open/floor/carpet/blue,
/area/city/backstreets_room)
"Q" = (
/obj/machinery/light{
	dir = 8
	},
/obj/effect/decal/cleanable/dirt/dust,
/obj/effect/decal/cleanable/dirt/dust,
/mob/living/simple_animal/hostile/humanoid/rat/zippy,
/turf/open/floor/carpet/blue,
/area/city/backstreets_room)
"R" = (
/obj/effect/decal/cleanable/dirt/dust,
/obj/effect/decal/cleanable/dirt/dust,
/obj/effect/decal/cleanable/dirt/dust,
/turf/open/floor/carpet/blue,
/area/city/backstreets_room)
"S" = (
/obj/effect/decal/cleanable/dirt/dust,
/obj/effect/decal/cleanable/dirt/dust,
/obj/effect/decal/cleanable/dirt/dust,
/obj/effect/decal/cleanable/dirt/dust,
/turf/open/floor/carpet/blue,
/area/city/backstreets_room)
"U" = (
/turf/closed/indestructible/reinforced,
/area/city/backstreets_room)

(1,1,1) = {"
U
U
U
U
U
"}
(2,1,1) = {"
U
D
R
Q
P
"}
(3,1,1) = {"
U
M
u
R
U
"}
(4,1,1) = {"
U
C
u
a
U
"}
(5,1,1) = {"
U
t
S
x
U
"}
(6,1,1) = {"
U
n
f
B
U
"}
(7,1,1) = {"
U
U
U
U
U
"}
