//MAP CONVERTED BY dmm2tgm.py THIS HEADER COMMENT PREVENTS RECONVERSION, DO NOT REMOVE
"a" = (
/obj/effect/decal/cleanable/dirt/dust,
/obj/machinery/grill,
/obj/item/stack/sheet/mineral/wood,
/obj/effect/turf_decal/tile/neutral{
	dir = 1;
	color = "#000000"
	},
/obj/effect/turf_decal/tile/neutral{
	dir = 4;
	color = "#000000"
	},
/obj/effect/turf_decal/tile/neutral{
	color = "#090807"
	},
/obj/effect/turf_decal/tile/neutral{
	dir = 8;
	color = "#000000"
	},
/obj/machinery/light{
	dir = 1;
	pixel_y = 19
	},
/obj/machinery/light{
	dir = 8;
	pixel_x = -9;
	pixel_y = 4
	},
/turf/open/floor/plasteel/sepia{
	color = "#ccc8c0"
	},
/area/city/fixers)
"b" = (
/obj/structure/lattice/catwalk{
	resistance_flags = 115;
	name = "wing-grade catwalk";
	desc = "A catwalk for easy traversal over difficult terrain with a fraction of the cost."
	},
/obj/machinery/light{
	dir = 8;
	pixel_x = -9;
	pixel_y = 4
	},
/turf/open/floor/holofloor/beach/water,
/area/city/fixers)
"f" = (
/obj/structure/aquarium{
	pixel_y = 19;
	density = 0
	},
/obj/effect/turf_decal/tile/neutral{
	dir = 8
	},
/obj/effect/turf_decal/tile/neutral,
/obj/effect/decal/cleanable/dirt,
/turf/open/floor/plasteel/sepia{
	color = "#ccc8c0"
	},
/area/city/fixers)
"g" = (
/obj/effect/turf_decal/tile/neutral{
	color = "#090807"
	},
/obj/effect/turf_decal/tile/neutral{
	dir = 4;
	color = "#000000"
	},
/obj/effect/turf_decal/tile/neutral{
	dir = 1;
	color = "#000000"
	},
/obj/effect/turf_decal/tile/neutral{
	dir = 8;
	color = "#000000"
	},
/obj/effect/turf_decal/siding/thinplating,
/obj/machinery/fish_market,
/obj/structure/railing,
/turf/open/floor/plasteel/sepia{
	color = "#ccc8c0"
	},
/area/city/fixers)
"i" = (
/obj/machinery/paystand,
/obj/effect/turf_decal/tile/neutral{
	dir = 8;
	color = "#000000"
	},
/obj/effect/turf_decal/tile/neutral{
	color = "#090807"
	},
/obj/effect/turf_decal/tile/neutral{
	color = "#090807";
	dir = 4
	},
/obj/effect/turf_decal/tile/neutral{
	color = "#090807";
	dir = 1
	},
/obj/effect/turf_decal/siding/thinplating,
/obj/effect/decal/cleanable/dirt/dust,
/turf/open/floor/plasteel/sepia{
	color = "#ccc8c0"
	},
/area/city/fixers)
"o" = (
/obj/structure/table/wood/fancy/purple,
/obj/effect/spawner/lootdrop/donkpockets,
/obj/machinery/microwave{
	pixel_y = 7
	},
/obj/effect/turf_decal/tile/neutral{
	color = "#090807";
	dir = 4
	},
/obj/effect/turf_decal/tile/neutral{
	dir = 8;
	color = "#000000"
	},
/obj/effect/turf_decal/tile/neutral{
	color = "#090807"
	},
/obj/effect/turf_decal/tile/neutral{
	color = "#090807";
	dir = 1
	},
/obj/effect/turf_decal/siding/thinplating{
	dir = 8
	},
/turf/open/floor/plasteel/sepia{
	color = "#ccc8c0"
	},
/area/city/fixers)
"q" = (
/obj/structure/chair/sofa/corner{
	dir = 8
	},
/obj/effect/turf_decal/tile/neutral{
	color = "#090807";
	dir = 1
	},
/obj/effect/turf_decal/tile/neutral,
/obj/effect/turf_decal/tile/neutral{
	dir = 4
	},
/obj/effect/turf_decal/tile/neutral{
	dir = 8
	},
/turf/open/floor/plasteel/sepia{
	color = "#ccc8c0"
	},
/area/city/fixers)
"s" = (
/obj/structure/chair/sofa/left{
	dir = 1
	},
/obj/effect/turf_decal/tile/neutral{
	color = "#090807";
	dir = 1
	},
/obj/effect/turf_decal/tile/neutral{
	color = "#090807";
	dir = 4
	},
/obj/effect/turf_decal/tile/neutral{
	dir = 8
	},
/obj/effect/turf_decal/tile/neutral,
/obj/effect/turf_decal/siding/thinplating{
	dir = 8
	},
/obj/effect/decal/cleanable/dirt/dust,
/turf/open/floor/plasteel/sepia{
	color = "#ccc8c0"
	},
/area/city/fixers)
"x" = (
/obj/structure/table/wood/fancy/purple,
/obj/effect/turf_decal/tile/neutral{
	dir = 8;
	color = "#000000"
	},
/obj/effect/turf_decal/tile/neutral{
	color = "#090807"
	},
/obj/effect/turf_decal/tile/neutral{
	color = "#090807";
	dir = 4
	},
/obj/effect/turf_decal/tile/neutral{
	color = "#090807";
	dir = 1
	},
/obj/effect/turf_decal/siding/thinplating,
/obj/structure/railing,
/obj/structure/window/reinforced/spawner/east{
	resistance_flags = 115
	},
/turf/open/floor/plasteel/sepia{
	color = "#ccc8c0"
	},
/area/city/fixers)
"y" = (
/obj/machinery/door/window,
/obj/effect/turf_decal/tile/neutral,
/obj/effect/turf_decal/tile/neutral{
	dir = 4
	},
/obj/effect/turf_decal/tile/neutral{
	dir = 8
	},
/obj/effect/turf_decal/tile/neutral{
	dir = 1
	},
/obj/effect/turf_decal/siding/thinplating,
/obj/effect/decal/cleanable/dirt,
/turf/open/floor/plasteel/sepia{
	color = "#ccc8c0"
	},
/area/city/fixers)
"A" = (
/obj/structure/lattice/catwalk{
	resistance_flags = 115;
	name = "wing-grade catwalk";
	desc = "A catwalk for easy traversal over difficult terrain with a fraction of the cost."
	},
/turf/open/floor/holofloor/beach/water,
/area/city/fixers)
"G" = (
/obj/structure/closet/crate,
/obj/item/storage/bag/fish,
/obj/item/storage/bag/fish,
/obj/item/storage/bag/fish,
/obj/item/fishing_net,
/obj/item/fishing_net,
/obj/item/fishing_net,
/obj/item/fishing_net,
/obj/item/fishing_net,
/obj/item/storage/box/fishing,
/obj/item/storage/box/fishing,
/obj/item/storage/box/fishing,
/turf/open/floor/plasteel/sepia,
/area/city/fixers)
"J" = (
/obj/structure/aquarium{
	pixel_y = 19;
	density = 0
	},
/obj/effect/turf_decal/tile/neutral{
	dir = 8
	},
/obj/effect/turf_decal/tile/neutral,
/obj/machinery/light{
	dir = 1;
	pixel_y = 19
	},
/turf/open/floor/plasteel/sepia{
	color = "#ccc8c0"
	},
/area/city/fixers)
"L" = (
/obj/structure/table/wood/fancy/purple,
/obj/structure/railing,
/obj/effect/turf_decal/tile/neutral{
	dir = 8;
	color = "#000000"
	},
/obj/effect/turf_decal/tile/neutral{
	color = "#090807"
	},
/obj/effect/turf_decal/tile/neutral{
	color = "#090807";
	dir = 4
	},
/obj/effect/turf_decal/tile/neutral{
	color = "#090807";
	dir = 1
	},
/obj/item/flashlight/lamp{
	pixel_y = 15;
	pixel_x = 13
	},
/obj/item/paper_bin/carbon{
	pixel_y = 6;
	pixel_x = -2
	},
/obj/effect/turf_decal/siding/thinplating,
/turf/open/floor/plasteel/sepia{
	color = "#ccc8c0"
	},
/area/city/fixers)
"M" = (
/obj/structure/chair/sofa/right{
	dir = 8
	},
/obj/effect/turf_decal/tile/neutral{
	color = "#090807";
	dir = 1
	},
/obj/effect/turf_decal/tile/neutral{
	dir = 8;
	color = "#000000"
	},
/obj/effect/turf_decal/tile/neutral,
/obj/effect/turf_decal/tile/neutral{
	dir = 4
	},
/obj/effect/decal/cleanable/dirt/dust,
/turf/open/floor/plasteel/sepia{
	color = "#ccc8c0"
	},
/area/city/fixers)
"N" = (
/obj/structure/aquarium{
	pixel_y = 19;
	density = 0
	},
/obj/effect/turf_decal/tile/neutral{
	dir = 8
	},
/obj/effect/turf_decal/tile/neutral,
/obj/item/storage/secure/safe{
	pixel_x = 30
	},
/obj/machinery/light{
	dir = 1;
	pixel_y = 19
	},
/turf/open/floor/plasteel/sepia{
	color = "#ccc8c0"
	},
/area/city/fixers)
"Q" = (
/obj/effect/turf_decal/tile/neutral{
	dir = 1
	},
/obj/effect/turf_decal/tile/neutral{
	dir = 8
	},
/obj/effect/turf_decal/tile/neutral{
	dir = 4;
	color = "#000000"
	},
/obj/effect/turf_decal/tile/neutral{
	color = "#090807"
	},
/obj/effect/turf_decal/stripes/red/line{
	dir = 8
	},
/obj/effect/turf_decal/caution/red{
	dir = 4
	},
/obj/effect/turf_decal/siding/thinplating{
	dir = 4
	},
/turf/open/floor/plasteel/sepia{
	color = "#ccc8c0"
	},
/area/city/fixers)
"S" = (
/obj/structure/closet/crate,
/obj/item/storage/fish_case,
/obj/item/storage/fish_case,
/obj/item/fish_feed,
/obj/item/fish_feed,
/obj/item/fish_feed,
/obj/item/fish_feed,
/obj/item/fish_feed,
/obj/item/clothing/under/suit/lobotomy/fishhook,
/obj/item/clothing/under/suit/lobotomy/fishhook,
/obj/item/clothing/under/suit/lobotomy/fishhook,
/obj/item/clothing/under/suit/lobotomy/fishhook,
/obj/effect/decal/cleanable/dirt/dust,
/obj/machinery/light{
	dir = 8;
	pixel_x = -9;
	pixel_y = 4
	},
/turf/open/floor/plasteel/sepia,
/area/city/fixers)
"W" = (
/obj/structure/aquarium{
	pixel_y = 19;
	density = 0
	},
/obj/effect/turf_decal/tile/neutral{
	dir = 8
	},
/obj/effect/turf_decal/tile/neutral,
/obj/structure/chair/comfy/brown,
/obj/effect/decal/cleanable/dirt,
/turf/open/floor/plasteel/sepia{
	color = "#ccc8c0"
	},
/area/city/fixers)
"X" = (
/obj/effect/turf_decal/tile/neutral{
	dir = 1
	},
/obj/effect/turf_decal/tile/neutral{
	dir = 8
	},
/obj/effect/turf_decal/tile/neutral{
	dir = 4;
	color = "#000000"
	},
/obj/effect/turf_decal/tile/neutral{
	color = "#090807"
	},
/obj/effect/turf_decal/stripes/red/line{
	dir = 8
	},
/obj/effect/turf_decal/caution/red{
	dir = 4
	},
/obj/effect/turf_decal/siding/thinplating{
	dir = 4
	},
/obj/effect/decal/cleanable/dirt/dust,
/turf/open/floor/plasteel/sepia{
	color = "#ccc8c0"
	},
/area/city/fixers)

(1,1,1) = {"
a
g
b
G
S
"}
(2,1,1) = {"
f
y
A
X
Q
"}
(3,1,1) = {"
J
L
A
A
A
"}
(4,1,1) = {"
W
x
A
o
s
"}
(5,1,1) = {"
N
i
A
M
q
"}
