//MAP CONVERTED BY dmm2tgm.py THIS HEADER COMMENT PREVENTS RECONVERSION, DO NOT REMOVE
"a" = (
/turf/open/floor/plating,
/area/city/backstreets_room)
"s" = (
/turf/closed/indestructible/fakedoor,
/area/city/backstreets_room)
"v" = (
/obj/item/folder/syndicate/red{
	desc = "A folder belonging to one of the City's corporations.";
	name = "Corporation Folder"
	},
/turf/open/floor/plating,
/area/city/backstreets_room)
"B" = (
/obj/effect/light_emitter{
	light_power = 4;
	light_range = 25;
	set_cap = 3;
	set_luminosity = 24
	},
/turf/open/floor/plating,
/area/city/backstreets_room)
"G" = (
/obj/item/folder/blue{
	desc = "Appears to be permits and documents of an unspecified workshop.";
	name = "Workshop Folder"
	},
/turf/open/floor/plating,
/area/city/backstreets_room)
"I" = (
/obj/item/folder/white{
	desc = "Looks to be remnants of the old G-Corp.";
	name = "Outdated G-Corp Folder"
	},
/turf/open/floor/plating,
/area/city/backstreets_room)
"J" = (
/turf/closed/indestructible/reinforced,
/area/city/backstreets_room)
"N" = (
/obj/item/folder/syndicate/blue{
	desc = "You have a feeling that these series of documents within this folder are not for the average person to gaze at.";
	name = "Highly Confidential Folder"
	},
/turf/open/floor/plating,
/area/city/backstreets_room)

(1,1,1) = {"
J
J
J
J
J
J
J
J
J
J
J
J
J
J
J
J
J
J
J
J
"}
(2,1,1) = {"
J
a
a
a
a
a
a
a
a
a
a
a
a
a
a
a
a
a
a
J
"}
(3,1,1) = {"
J
a
a
a
a
a
a
a
a
a
a
a
a
a
a
a
a
a
a
J
"}
(4,1,1) = {"
J
a
a
a
a
a
a
a
a
a
a
a
a
a
a
a
a
a
a
J
"}
(5,1,1) = {"
J
a
a
a
a
a
a
a
a
a
a
a
a
a
a
a
a
a
a
J
"}
(6,1,1) = {"
J
a
a
a
a
a
a
a
a
a
a
a
a
a
a
a
a
a
a
J
"}
(7,1,1) = {"
J
a
a
a
a
a
a
a
a
a
a
a
a
a
a
a
a
a
a
J
"}
(8,1,1) = {"
J
a
a
a
a
B
a
a
a
a
a
a
B
a
a
a
a
a
a
J
"}
(9,1,1) = {"
J
a
a
a
a
N
a
a
a
a
a
a
G
a
a
a
a
a
a
s
"}
(10,1,1) = {"
J
a
a
a
a
a
a
a
a
a
a
a
a
a
a
a
a
a
a
s
"}
(11,1,1) = {"
J
a
a
a
a
a
a
a
a
a
a
a
a
a
a
a
a
a
a
s
"}
(12,1,1) = {"
J
a
a
a
a
v
a
a
a
a
a
a
I
a
a
a
a
a
a
s
"}
(13,1,1) = {"
J
a
a
a
a
B
a
a
a
a
a
a
B
a
a
a
a
a
a
J
"}
(14,1,1) = {"
J
a
a
a
a
a
a
a
a
a
a
a
a
a
a
a
a
a
a
J
"}
(15,1,1) = {"
J
a
a
a
a
a
a
a
a
a
a
a
a
a
a
a
a
a
a
J
"}
(16,1,1) = {"
J
a
a
a
a
a
a
a
a
a
a
a
a
a
a
a
a
a
a
J
"}
(17,1,1) = {"
J
a
a
a
a
a
a
a
a
a
a
a
a
a
a
a
a
a
a
J
"}
(18,1,1) = {"
J
a
a
a
a
a
a
a
a
a
a
a
a
a
a
a
a
a
a
J
"}
(19,1,1) = {"
J
a
a
a
a
a
a
a
a
a
a
a
a
a
a
a
a
a
a
J
"}
(20,1,1) = {"
J
J
J
J
J
J
J
J
J
J
J
J
J
J
J
J
J
J
J
J
"}
