//MAP CONVERTED BY dmm2tgm.py THIS HEADER COMMENT PREVENTS RECONVERSION, DO NOT REMOVE
"co" = (
/obj/structure/lootcrate/w_corp,
/turf/open/floor/plasteel/dark,
/area/city/backstreets_room)
"kx" = (
/obj/structure/lootcrate/syndicate,
/turf/open/floor/plasteel/dark,
/area/city/backstreets_room)
"vv" = (
/mob/living/simple_animal/hostile/ordeal/green_dusk,
/turf/open/floor/circuit/green,
/area/city/backstreets_room)
"An" = (
/turf/closed/indestructible/reinforced,
/area/city/backstreets_room)
"PH" = (
/turf/closed/indestructible/rock,
/area/city/backstreets_room)
"SY" = (
/turf/open/floor/circuit/green,
/area/city/backstreets_room)
"ZT" = (
/turf/open/floor/plasteel/dark,
/area/city/backstreets_room)

(1,1,1) = {"
PH
PH
PH
An
An
An
An
An
An
An
An
An
An
An
An
An
An
An
PH
PH
"}
(2,1,1) = {"
PH
PH
An
An
ZT
ZT
ZT
ZT
ZT
ZT
ZT
ZT
ZT
ZT
ZT
ZT
ZT
An
An
PH
"}
(3,1,1) = {"
PH
An
An
co
ZT
ZT
ZT
ZT
ZT
ZT
ZT
ZT
ZT
ZT
ZT
ZT
ZT
ZT
An
An
"}
(4,1,1) = {"
An
An
ZT
ZT
ZT
ZT
ZT
ZT
ZT
ZT
ZT
ZT
ZT
ZT
ZT
ZT
ZT
ZT
ZT
An
"}
(5,1,1) = {"
An
ZT
ZT
ZT
ZT
ZT
ZT
ZT
ZT
ZT
ZT
ZT
ZT
ZT
ZT
ZT
ZT
ZT
ZT
An
"}
(6,1,1) = {"
An
co
ZT
ZT
ZT
ZT
ZT
ZT
ZT
SY
SY
SY
SY
ZT
ZT
ZT
An
ZT
ZT
An
"}
(7,1,1) = {"
An
ZT
ZT
ZT
ZT
ZT
ZT
ZT
SY
SY
SY
SY
SY
SY
ZT
ZT
An
An
ZT
An
"}
(8,1,1) = {"
An
ZT
ZT
ZT
ZT
ZT
ZT
SY
SY
SY
SY
ZT
SY
SY
SY
SY
ZT
An
ZT
An
"}
(9,1,1) = {"
An
ZT
kx
ZT
ZT
ZT
ZT
SY
SY
SY
ZT
ZT
SY
SY
SY
ZT
ZT
An
ZT
ZT
"}
(10,1,1) = {"
An
ZT
ZT
ZT
ZT
ZT
ZT
SY
SY
vv
SY
SY
SY
SY
SY
SY
ZT
An
ZT
An
"}
(11,1,1) = {"
An
ZT
ZT
ZT
ZT
ZT
ZT
SY
SY
SY
SY
SY
SY
SY
SY
SY
ZT
An
ZT
An
"}
(12,1,1) = {"
An
ZT
ZT
ZT
ZT
ZT
ZT
SY
SY
SY
ZT
ZT
SY
SY
SY
ZT
ZT
An
ZT
ZT
"}
(13,1,1) = {"
An
ZT
ZT
ZT
co
ZT
ZT
SY
SY
SY
SY
ZT
SY
SY
SY
SY
ZT
An
ZT
An
"}
(14,1,1) = {"
An
ZT
ZT
ZT
ZT
ZT
ZT
ZT
SY
SY
SY
SY
SY
SY
ZT
ZT
An
An
ZT
An
"}
(15,1,1) = {"
An
kx
ZT
ZT
ZT
ZT
ZT
ZT
ZT
SY
SY
SY
SY
ZT
ZT
ZT
An
ZT
ZT
An
"}
(16,1,1) = {"
An
ZT
ZT
ZT
ZT
ZT
ZT
ZT
ZT
ZT
ZT
ZT
ZT
ZT
ZT
ZT
ZT
ZT
ZT
An
"}
(17,1,1) = {"
An
An
ZT
kx
ZT
ZT
ZT
ZT
ZT
ZT
ZT
ZT
ZT
ZT
ZT
ZT
ZT
ZT
ZT
An
"}
(18,1,1) = {"
PH
An
An
ZT
ZT
ZT
ZT
ZT
ZT
ZT
ZT
ZT
ZT
ZT
ZT
ZT
ZT
ZT
An
An
"}
(19,1,1) = {"
PH
PH
An
An
ZT
ZT
ZT
ZT
ZT
ZT
ZT
ZT
ZT
ZT
ZT
ZT
ZT
An
An
PH
"}
(20,1,1) = {"
PH
PH
PH
An
An
An
An
An
An
An
An
An
An
An
An
An
An
An
PH
PH
"}
