"a" = (/turf/closed/indestructible/reinforced,/area/city/backstreets_room)
"c" = (/turf/open/floor/plating/ironsand,/area/city/backstreets_room)
"d" = (/obj/structure/mineral_door/wood,/obj/structure/barricade/wooden/crude,/turf/open/floor/wood,/area/city/backstreets_room)
"f" = (/obj/structure/flora/rock/pile/largejungle,/obj/structure/flora/rock/pile/largejungle,/obj/structure/flora/rock/pile/largejungle,/obj/structure/flora/rock/pile/largejungle,/turf/open/water/jungle,/area/city/backstreets_room)
"i" = (/obj/structure/table/wood,/obj/item/instrument/saxophone,/turf/open/floor/wood,/area/city/backstreets_room)
"p" = (/obj/effect/landmark/cratespawn,/turf/open/floor/wood,/area/city/backstreets_room)
"u" = (/turf/closed/indestructible/wood,/area/city/backstreets_room)
"v" = (/mob/living/simple_animal/hostile/clan/scout,/turf/open/floor/wood,/area/city/backstreets_room)
"C" = (/turf/open/floor/grass/fakebasalt,/area/city/backstreets_room)
"E" = (/turf/open/floor/wood,/area/city/backstreets_room)
"F" = (/obj/structure/flora/ausbushes/fullgrass,/turf/open/floor/plating/ironsand,/area/city/backstreets_room)
"V" = (/obj/structure/table/wood,/obj/item/clothing/under/costume/singer/yellow,/obj/item/clothing/shoes/workboots,/turf/open/floor/wood,/area/city/backstreets_room)

(1,1,1) = {"
aauuuuuaaa
acupEVucca
aFuEviucfa
acuuduucca
aCcccFCcca
aCCccCCCCa
"}
