//MAP CONVERTED BY dmm2tgm.py THIS HEADER COMMENT PREVENTS RECONVERSION, DO NOT REMOVE
"a" = (
/obj/machinery/door/airlock/wood,
/turf/open/floor/plating,
/area/city/backstreets_room)
"b" = (
/obj/effect/landmark/cratespawn,
/turf/open/floor/wood,
/area/city/backstreets_room)
"c" = (
/turf/open/floor/wood,
/area/city/backstreets_room)
"d" = (
/mob/living/simple_animal/hostile/humanoid/rat/knife,
/turf/open/floor/wood,
/area/city/backstreets_room)
"f" = (
/obj/item/chair/wood,
/turf/open/floor/wood,
/area/city/backstreets_room)
"h" = (
/obj/effect/decal/cleanable/dirt/dust,
/obj/effect/spawner/lootdrop/cigbutt,
/turf/open/floor/wood,
/area/city/backstreets_room)
"k" = (
/mob/living/simple_animal/hostile/humanoid/rat/pipe,
/turf/open/floor/wood,
/area/city/backstreets_room)
"l" = (
/obj/effect/spawner/lootdrop/cigbutt,
/turf/open/floor/wood,
/area/city/backstreets_room)
"t" = (
/obj/item/trash/can/food/peaches/maint,
/turf/open/floor/wood,
/area/city/backstreets_room)
"u" = (
/obj/structure/table/anvil,
/obj/item/reagent_containers/food/drinks/soda_cans/oceanwave/spacedrugs,
/turf/open/floor/wood,
/area/city/backstreets_room)
"w" = (
/obj/structure/bed/maint,
/obj/effect/decal/cleanable/dirt/dust,
/mob/living/simple_animal/hostile/humanoid/rat/hammer,
/turf/open/floor/wood,
/area/city/backstreets_room)
"x" = (
/obj/effect/decal/cleanable/dirt/dust,
/obj/item/broken_missile,
/turf/open/floor/wood,
/area/city/backstreets_room)
"z" = (
/obj/machinery/computer/security/wooden_tv{
	desc = "An old television that does not seem to work as intended.";
	name = "television"
	},
/turf/open/floor/wood,
/area/city/backstreets_room)
"A" = (
/mob/living/simple_animal/hostile/humanoid/rat/hammer,
/turf/open/floor/wood,
/area/city/backstreets_room)
"B" = (
/obj/item/food/canned/peaches/maint,
/obj/item/food/canned/peaches/maint,
/obj/effect/decal/cleanable/dirt/dust,
/turf/open/floor/wood,
/area/city/backstreets_room)
"I" = (
/obj/effect/decal/cleanable/dirt/dust,
/turf/open/floor/wood,
/area/city/backstreets_room)
"Q" = (
/turf/closed/indestructible/reinforced,
/area/city/backstreets_room)
"R" = (
/obj/effect/decal/cleanable/dirt/dust,
/mob/living/simple_animal/hostile/humanoid/rat/hammer,
/turf/open/floor/wood,
/area/city/backstreets_room)
"S" = (
/obj/structure/table_frame/wood,
/turf/open/floor/wood,
/area/city/backstreets_room)
"Z" = (
/obj/structure/lootcrate/money,
/turf/open/floor/wood,
/area/city/backstreets_room)

(1,1,1) = {"
Q
Q
Q
Q
Q
Q
"}
(2,1,1) = {"
Q
w
c
b
u
Q
"}
(3,1,1) = {"
Q
l
I
c
B
Q
"}
(4,1,1) = {"
Q
l
k
c
Z
Q
"}
(5,1,1) = {"
Q
z
x
c
c
Q
"}
(6,1,1) = {"
Q
b
c
t
h
Q
"}
(7,1,1) = {"
Q
I
d
k
c
Q
"}
(8,1,1) = {"
Q
f
l
c
c
Q
"}
(9,1,1) = {"
Q
S
I
A
R
a
"}
(10,1,1) = {"
Q
Q
Q
Q
Q
Q
"}
