//MAP CONVERTED BY dmm2tgm.py THIS HEADER COMMENT PREVENTS RECONVERSION, DO NOT REMOVE
"a" = (
/turf/closed/indestructible/reinforced,
/area/city/backstreets_room)
"n" = (
/turf/closed/indestructible/fakedoor{
	name = "Malfunctioning Door"
	},
/area/city/backstreets_room)
"o" = (
/obj/effect/decal/cleanable/blood,
/turf/open/floor/plating/dirt/jungle/dark,
/area/city/backstreets_room)
"C" = (
/obj/effect/decal/cleanable/garbage,
/turf/open/floor/plating/dirt/jungle/dark,
/area/city/backstreets_room)
"L" = (
/obj/structure/closet/crate/trashcart/filled{
	anchored = 1
	},
/turf/open/floor/plating/dirt/jungle/dark,
/area/city/backstreets_room)
"N" = (
/obj/structure/bed/maint,
/obj/effect/decal/cleanable/blood,
/obj/effect/mob_spawn/human/clown/corpse{
	name = "Crinkles the Clown"
	},
/turf/open/floor/plating/dirt/jungle/dark,
/area/city/backstreets_room)
"P" = (
/obj/item/paperslip{
	pixel_x = -41;
	pixel_y = -8
	},
/obj/item/paper{
	pixel_x = -17;
	pixel_y = -6
	},
/obj/item/paperslip{
	pixel_x = 7;
	pixel_y = -5
	},
/obj/item/paperslip{
	pixel_x = -8;
	pixel_y = 5
	},
/obj/item/paper{
	pixel_x = -12;
	pixel_y = 13
	},
/obj/item/paper{
	pixel_x = -1;
	pixel_y = 7
	},
/obj/item/folder/documents{
	desc = "A folder once belonged to a certain ambitious clown.";
	name = "folder- '8 o'clock Circus Application'"
	},
/obj/machinery/light/dim{
	dir = 4
	},
/turf/open/floor/plating/dirt/jungle/dark,
/area/city/backstreets_room)
"R" = (
/obj/effect/decal/cleanable/blood/tracks{
	dir = 8
	},
/mob/living/simple_animal/hostile/ordeal/indigo_dawn{
	name = "sweeper scout"
	},
/obj/item/paper/crumpled{
	pixel_x = 5;
	pixel_y = -5
	},
/obj/item/paper/crumpled{
	pixel_x = 10
	},
/obj/item/paper/crumpled{
	pixel_x = -10
	},
/turf/open/floor/plating/dirt/jungle/dark,
/area/city/backstreets_room)
"X" = (
/turf/open/floor/plating/dirt/jungle/dark,
/area/city/backstreets_room)
"Z" = (
/obj/effect/decal/cleanable/blood/tracks{
	dir = 4
	},
/turf/open/floor/plating/dirt/jungle/dark,
/area/city/backstreets_room)

(1,1,1) = {"
a
C
X
X
X
C
a
"}
(2,1,1) = {"
a
L
R
X
C
L
a
"}
(3,1,1) = {"
a
L
Z
C
o
L
a
"}
(4,1,1) = {"
a
N
P
X
X
C
a
"}
(5,1,1) = {"
a
a
a
n
a
a
a
"}
