//MAP CONVERTED BY dmm2tgm.py THIS HEADER COMMENT PREVENTS RECONVERSION, DO NOT REMOVE
"a" = (
/turf/closed/indestructible/reinforced,
/area/city/backstreets_room)
"o" = (
/obj/structure/reagent_dispensers/water_cooler,
/turf/open/floor/plasteel/showroomfloor,
/area/city/backstreets_room)
"q" = (
/obj/machinery/medipen_refiller,
/turf/open/floor/plasteel/showroomfloor,
/area/city/backstreets_room)
"v" = (
/obj/structure/table,
/turf/open/floor/plasteel/showroomfloor,
/area/city/backstreets_room)
"x" = (
/obj/structure/chair/sofa/corp/left{
	dir = 8
	},
/turf/open/floor/plasteel/showroomfloor,
/area/city/backstreets_room)
"C" = (
/obj/item/kirbyplants/random{
	pixel_y = 10
	},
/turf/open/floor/plasteel/showroomfloor,
/area/city/backstreets_room)
"E" = (
/obj/machinery/vending/medical,
/obj/machinery/light,
/turf/open/floor/plasteel/showroomfloor,
/area/city/backstreets_room)
"I" = (
/obj/structure/chair/sofa/corp{
	dir = 8
	},
/turf/open/floor/plasteel/showroomfloor,
/area/city/backstreets_room)
"J" = (
/obj/structure/chair/sofa/corp/right{
	dir = 8
	},
/turf/open/floor/plasteel/showroomfloor,
/area/city/backstreets_room)
"L" = (
/obj/structure/chair/greyscale{
	dir = 8
	},
/obj/machinery/light{
	dir = 1
	},
/turf/open/floor/plasteel/showroomfloor,
/area/city/backstreets_room)
"N" = (
/turf/open/floor/plasteel/showroomfloor,
/area/city/backstreets_room)
"X" = (
/obj/machinery/door/airlock/public/glass{
	name = "Medical Kiosk"
	},
/turf/open/floor/plasteel/showroomfloor,
/area/city/backstreets_room)

(1,1,1) = {"
a
a
X
a
X
a
a
"}
(2,1,1) = {"
a
v
N
o
N
C
a
"}
(3,1,1) = {"
a
L
N
N
N
E
a
"}
(4,1,1) = {"
a
N
J
I
x
q
a
"}
(5,1,1) = {"
a
a
a
a
a
a
a
"}
