//MAP CONVERTED BY dmm2tgm.py THIS HEADER COMMENT PREVENTS RECONVERSION, DO NOT REMOVE
"a" = (
/turf/closed/indestructible/rock,
/area/city/outskirts)
"g" = (
/obj/effect/landmark/nobasic_incorp_move,
/turf/closed/indestructible/rock,
/area/city/outskirts)
"i" = (
/turf/open/floor/plating/asteroid,
/area/city/outskirts)
"m" = (
/obj/effect/landmark/abnospawn/easytank,
/turf/open/floor/plating/asteroid,
/area/city/outskirts)
"G" = (
/obj/effect/landmark/abnospawn/easysupport,
/turf/open/floor/plating/asteroid,
/area/city/outskirts)
"H" = (
/obj/effect/landmark/abnospawn/easycombat,
/turf/open/floor/plating/asteroid,
/area/city/outskirts)

(1,1,1) = {"
a
a
a
a
a
a
a
a
a
a
a
a
a
a
a
a
a
a
a
a
a
a
a
a
a
a
a
a
a
a
a
a
a
a
a
a
a
a
a
a
a
a
a
a
a
a
a
a
a
a
a
a
a
a
a
a
a
a
a
a
a
a
a
a
a
a
a
a
a
a
a
a
a
a
a
a
a
a
a
a
a
a
a
a
a
a
a
a
a
a
a
a
a
a
a
a
a
a
a
a
a
a
a
a
a
a
a
a
a
a
a
a
a
a
a
a
a
a
a
a
a
a
"}
(2,1,1) = {"
a
a
a
a
a
a
a
a
a
a
a
a
a
a
a
a
a
a
a
a
a
a
a
a
a
a
a
a
a
a
a
a
a
a
a
a
a
a
a
a
a
a
a
a
a
a
a
a
a
a
a
a
a
a
a
a
a
a
a
a
a
a
a
a
a
a
a
a
a
a
a
a
a
a
a
a
a
a
a
a
a
a
a
a
a
a
a
a
a
a
a
a
a
a
a
a
a
a
a
a
a
a
a
a
a
a
a
a
a
a
a
a
a
a
a
a
a
a
a
a
a
a
"}
(3,1,1) = {"
a
a
a
a
a
a
a
a
a
a
a
a
a
a
a
a
a
a
a
a
a
a
a
a
a
a
a
a
a
a
a
a
a
a
a
a
a
a
a
a
a
a
a
a
a
a
a
a
a
a
a
a
a
a
a
a
a
a
a
a
a
a
a
a
a
a
a
a
a
a
a
a
a
a
a
a
a
a
a
a
a
a
a
a
a
a
a
a
a
a
a
a
a
a
a
a
a
a
a
a
a
a
a
a
a
a
a
a
a
a
a
a
a
a
a
a
a
a
a
a
a
a
"}
(4,1,1) = {"
a
a
a
a
a
a
a
a
a
a
a
a
a
a
a
a
a
a
a
a
a
a
a
a
a
a
a
a
a
a
a
a
a
a
a
a
a
a
a
a
a
a
a
a
a
a
a
a
a
a
a
a
a
a
a
a
a
a
a
a
a
a
a
a
a
a
a
a
a
a
a
a
a
a
a
a
a
a
a
a
a
a
a
a
a
a
a
a
a
a
a
a
a
a
a
a
a
a
a
a
a
a
a
a
a
a
a
a
a
a
a
a
a
a
a
a
a
a
a
a
a
a
"}
(5,1,1) = {"
a
a
a
a
a
a
a
a
a
a
a
a
a
a
a
a
a
a
a
a
a
a
a
a
a
a
a
a
a
a
a
a
a
a
a
a
a
a
a
a
a
a
a
a
a
a
a
a
a
a
a
a
a
a
a
a
a
a
a
a
a
a
a
a
a
a
a
a
a
a
a
a
a
a
a
a
a
a
a
a
a
a
a
a
a
a
a
a
a
a
a
a
a
a
a
a
a
a
a
a
a
a
a
a
a
a
a
a
a
a
a
a
a
a
a
a
a
a
a
a
a
a
"}
(6,1,1) = {"
a
a
a
a
a
a
a
a
a
a
a
a
a
a
a
a
a
a
a
a
a
a
a
a
a
a
a
a
a
a
a
a
a
a
a
a
a
a
a
a
a
a
a
a
a
a
a
a
a
a
a
a
a
a
a
a
a
a
a
a
a
a
a
a
a
a
a
a
a
a
a
a
a
a
a
a
a
a
a
a
a
a
a
a
a
a
a
a
a
a
a
a
a
a
a
a
a
a
a
a
a
a
a
a
a
a
a
a
a
a
a
a
a
a
a
a
a
a
a
a
a
a
"}
(7,1,1) = {"
a
a
a
a
a
a
a
a
a
a
a
a
a
a
a
a
a
a
a
a
a
a
a
a
a
a
a
a
a
a
a
a
a
a
a
a
a
a
a
a
a
a
a
a
a
a
a
a
a
a
a
a
a
a
a
a
a
a
a
a
a
a
a
a
a
a
a
a
a
a
a
a
a
a
a
a
a
a
a
a
a
a
a
a
a
a
a
a
a
a
a
a
a
a
a
a
a
a
a
a
a
a
a
a
a
a
a
a
a
a
a
a
a
a
a
a
a
a
a
a
a
a
"}
(8,1,1) = {"
a
a
a
a
a
a
a
a
a
a
a
a
a
a
a
a
a
a
a
a
a
a
a
a
a
a
a
a
a
a
a
a
a
a
a
a
a
a
a
a
a
a
a
a
a
a
a
a
a
a
a
a
a
a
a
a
a
a
a
a
a
a
a
a
a
a
a
a
a
a
a
a
a
a
a
a
a
a
a
a
a
a
a
a
a
a
a
a
a
a
a
a
a
a
a
a
a
a
a
a
a
a
a
a
a
a
g
g
g
g
g
g
a
a
a
a
a
a
a
a
a
a
"}
(9,1,1) = {"
a
a
a
a
a
a
a
a
a
a
a
a
a
a
a
a
a
a
a
a
a
a
a
a
a
a
a
a
a
a
a
a
a
a
a
a
a
a
a
a
a
a
a
a
a
a
a
a
a
a
a
a
a
a
a
a
a
a
a
a
a
a
a
a
a
a
a
a
a
a
a
a
a
a
a
a
a
a
a
a
a
a
a
a
a
a
a
a
a
a
a
a
a
a
a
a
a
a
a
a
a
a
g
g
g
g
g
i
i
i
i
g
g
g
g
g
a
a
a
a
a
a
"}
(10,1,1) = {"
a
a
a
a
a
a
a
a
a
a
a
a
a
a
a
a
a
a
a
a
a
a
a
a
a
a
a
a
a
a
a
a
a
a
a
a
a
a
a
a
a
a
a
a
a
a
a
a
a
a
a
a
a
a
a
a
a
a
a
a
a
a
a
a
a
a
a
a
a
a
a
a
a
a
a
a
a
a
a
a
a
a
a
a
a
a
a
a
a
a
a
a
a
a
a
a
a
a
a
a
a
g
g
i
i
i
i
i
i
i
i
i
i
i
i
g
a
a
a
a
a
a
"}
(11,1,1) = {"
a
a
a
a
a
a
a
a
a
a
a
a
a
a
a
a
a
a
a
a
a
a
a
a
a
a
a
a
a
a
a
a
a
a
a
a
a
a
a
a
a
a
a
a
a
a
a
a
a
a
a
a
a
a
a
a
a
a
a
a
a
g
g
g
g
g
g
g
g
g
g
g
a
a
a
a
a
a
a
a
a
a
a
a
a
a
a
a
a
a
a
a
a
a
a
a
a
a
a
a
a
g
i
i
i
i
i
i
i
i
i
i
i
i
i
g
g
a
a
a
a
a
"}
(12,1,1) = {"
a
a
a
a
a
a
a
a
a
a
a
a
a
a
a
a
a
a
a
a
a
a
a
a
a
a
a
a
a
a
a
a
a
a
a
a
a
a
a
a
a
a
a
a
a
a
a
a
a
a
a
a
a
a
a
a
a
g
g
g
g
g
i
i
i
i
i
i
i
i
i
g
g
g
a
a
a
a
a
a
a
a
a
a
a
a
a
a
a
a
a
a
a
a
a
a
a
a
a
a
a
g
i
i
i
i
i
i
i
i
i
i
i
i
i
i
g
a
a
a
a
a
"}
(13,1,1) = {"
a
a
a
a
a
a
a
a
a
a
a
a
a
a
a
a
a
a
a
a
a
a
a
a
a
a
a
a
a
a
a
a
a
a
a
a
a
a
a
a
a
a
a
a
a
a
a
a
a
a
a
a
a
a
a
g
g
g
i
i
i
i
i
i
i
i
i
i
i
i
i
i
i
g
g
g
a
a
a
a
a
a
a
a
a
a
a
a
a
a
a
a
a
a
a
a
a
a
a
a
g
g
i
i
i
i
i
i
i
i
i
i
i
i
i
i
g
a
a
a
a
a
"}
(14,1,1) = {"
a
a
a
a
a
a
a
a
a
a
a
a
a
a
a
a
a
a
a
a
a
a
a
a
a
a
a
a
a
a
a
a
a
a
a
a
a
a
a
a
a
a
a
a
a
a
a
a
a
a
a
a
a
a
g
g
i
i
i
i
i
i
i
i
i
i
i
i
i
i
i
i
i
i
i
g
g
a
a
a
a
a
a
a
a
a
a
a
a
a
a
a
a
a
a
a
a
a
a
a
g
i
i
i
i
i
i
i
i
i
i
i
i
i
i
i
g
g
g
a
a
a
"}
(15,1,1) = {"
a
a
a
a
a
a
a
a
a
a
a
a
a
a
a
a
a
a
a
a
a
a
a
a
a
a
a
a
a
a
a
a
a
a
a
a
a
a
a
a
a
a
a
a
a
a
a
a
a
a
a
g
g
g
g
i
i
i
i
i
i
i
i
i
i
i
i
i
i
i
i
i
i
i
i
i
g
g
a
a
a
a
a
a
a
a
a
a
a
a
a
a
a
a
a
a
a
a
g
g
g
i
i
i
i
i
i
i
i
i
i
i
i
i
i
i
i
i
g
g
a
a
"}
(16,1,1) = {"
a
a
a
a
a
a
a
a
a
a
a
a
a
a
a
a
a
a
a
a
a
a
a
a
a
a
a
a
a
a
a
a
a
a
a
a
a
a
a
a
a
a
a
a
a
a
a
a
a
g
g
g
i
i
i
i
i
i
i
i
i
i
i
i
i
i
i
i
i
i
i
i
i
i
i
i
i
g
g
a
a
a
a
a
a
a
a
a
a
a
a
a
a
a
a
a
g
g
g
i
i
i
i
i
i
i
i
i
g
g
i
i
i
i
i
i
i
i
i
g
a
a
"}
(17,1,1) = {"
a
a
a
a
a
a
a
a
a
a
a
a
a
a
a
a
a
a
a
a
a
a
a
a
a
a
a
a
a
a
a
a
a
a
a
a
a
a
a
a
a
a
a
a
a
a
a
g
g
g
i
i
i
i
i
i
i
i
i
i
i
i
i
i
i
i
i
i
i
i
i
i
i
i
i
i
i
i
g
g
g
a
a
a
a
a
a
a
a
a
a
a
a
a
a
a
g
i
i
i
i
i
i
i
i
i
i
g
a
a
g
i
i
i
i
i
i
i
i
g
g
a
"}
(18,1,1) = {"
a
a
a
a
a
a
a
a
a
a
a
a
a
a
a
a
a
a
a
a
a
a
a
a
a
a
a
a
a
a
a
a
a
a
a
a
a
a
a
a
a
a
a
a
a
g
g
g
i
i
i
i
i
i
i
i
i
i
i
i
i
i
i
i
i
i
i
i
i
i
i
i
i
i
i
i
i
i
i
i
g
g
a
a
a
a
a
a
a
a
a
a
a
a
a
g
g
i
i
i
i
i
i
i
i
i
i
g
a
a
g
g
i
i
i
i
i
i
i
i
g
g
"}
(19,1,1) = {"
a
a
a
a
a
a
a
a
a
a
a
a
a
a
a
a
a
a
a
a
a
a
a
a
a
a
a
a
a
a
a
a
a
a
a
a
a
a
a
g
g
g
g
g
g
g
i
i
i
i
i
i
i
i
i
i
i
i
i
i
i
i
i
i
i
i
i
i
i
i
i
i
i
i
i
i
i
i
i
i
i
g
g
a
a
a
a
a
a
a
a
a
a
a
a
g
i
i
i
i
i
i
i
i
i
i
g
a
a
a
a
g
i
i
i
i
i
i
i
i
i
g
"}
(20,1,1) = {"
a
a
a
a
a
a
a
a
a
a
a
a
a
a
a
a
a
a
a
a
a
a
a
a
a
a
a
a
a
a
a
a
a
a
a
a
a
a
g
g
i
i
i
i
i
i
i
i
i
i
i
i
i
i
i
i
i
i
i
i
i
i
i
g
g
g
g
g
g
g
i
i
i
i
i
i
i
i
i
i
i
i
g
g
a
a
a
a
a
a
a
g
g
g
g
g
i
i
i
i
i
i
i
i
i
i
g
a
a
a
a
g
g
g
i
i
i
i
i
i
i
i
"}
(21,1,1) = {"
a
a
a
a
a
a
a
a
a
a
a
a
a
a
a
a
a
a
a
a
a
a
a
a
a
a
a
a
a
a
a
a
a
a
a
a
a
g
g
i
i
i
i
i
i
i
i
i
i
i
i
i
i
i
i
i
i
i
i
i
g
g
g
a
a
a
a
g
g
i
i
i
i
i
i
g
i
i
i
i
i
i
i
g
g
a
a
a
a
a
g
g
i
i
i
i
i
i
i
i
i
i
i
i
i
i
g
a
a
a
a
g
g
g
g
i
i
i
i
i
i
i
"}
(22,1,1) = {"
a
a
a
a
a
a
a
a
a
a
a
a
a
a
a
a
a
a
a
a
a
a
a
a
a
a
a
a
a
a
a
a
a
a
a
a
g
g
i
i
i
i
i
i
i
i
i
i
i
i
i
i
i
i
i
i
i
g
g
g
a
a
a
a
a
a
g
i
i
i
i
i
i
i
g
g
i
i
i
i
i
i
i
i
g
a
a
a
a
a
g
i
i
i
i
i
i
i
i
i
i
i
i
i
i
g
a
a
a
g
g
g
i
g
g
g
i
i
i
i
i
i
"}
(23,1,1) = {"
a
a
a
a
a
a
a
a
a
a
a
a
a
a
a
a
a
a
a
a
a
a
a
a
a
a
a
a
a
a
a
a
a
a
a
g
g
i
i
i
i
i
i
i
i
i
i
i
i
i
i
i
i
i
i
g
g
a
a
a
a
a
a
a
a
g
i
i
i
i
i
i
i
g
a
a
g
i
i
i
i
i
i
i
g
g
a
a
a
g
g
i
i
i
i
G
i
m
i
i
i
i
i
i
i
g
a
a
g
g
i
i
i
i
i
i
i
i
i
i
i
i
"}
(24,1,1) = {"
a
a
a
a
a
a
a
a
a
a
a
a
a
a
a
a
a
a
a
a
a
a
a
a
a
a
a
a
a
a
a
a
a
a
a
g
i
i
i
i
i
i
i
i
i
i
i
i
i
i
i
i
i
i
g
a
a
a
a
a
a
a
a
a
g
g
i
i
i
i
i
i
g
a
a
a
a
g
i
i
i
i
i
i
i
g
a
a
g
g
i
i
i
i
i
i
i
i
i
i
i
i
i
i
g
a
a
a
g
i
i
i
i
i
i
i
i
i
i
i
i
i
"}
(25,1,1) = {"
a
a
a
a
a
a
a
a
a
a
a
a
a
a
a
a
a
a
a
a
a
a
a
a
a
a
a
a
a
a
a
a
a
a
a
g
i
i
i
i
i
i
i
i
i
i
i
i
i
i
i
i
i
g
a
a
a
a
a
a
a
a
a
g
i
i
i
i
i
i
i
g
a
a
a
g
g
g
g
g
i
i
i
i
i
g
g
a
g
i
i
i
i
i
H
i
i
i
m
i
i
i
i
i
g
a
a
a
g
i
i
i
i
i
i
i
i
i
i
i
i
g
"}
(26,1,1) = {"
a
a
a
a
a
a
a
a
a
a
a
a
a
a
a
a
a
a
a
a
a
a
a
a
a
a
a
a
a
a
a
a
a
a
a
g
i
i
i
i
i
i
i
i
i
i
i
i
i
i
i
i
g
a
a
a
a
a
a
a
a
a
a
g
i
i
i
i
i
i
g
a
a
g
g
i
i
i
i
i
i
i
i
i
i
i
g
g
g
i
i
i
i
i
i
i
G
i
i
i
i
i
i
g
a
a
a
a
g
g
i
i
i
i
i
i
i
i
i
g
g
a
"}
(27,1,1) = {"
a
a
a
a
a
a
a
a
a
a
a
a
a
a
a
a
a
a
a
a
a
a
a
a
a
a
a
a
a
a
a
a
a
a
a
g
i
i
i
i
i
i
i
i
i
i
i
i
i
i
g
g
a
a
a
a
a
a
a
a
a
a
g
i
i
i
i
i
i
i
g
g
g
i
i
i
i
i
i
i
i
i
i
i
i
i
i
i
i
i
i
i
i
i
i
i
i
i
i
i
i
i
g
a
a
a
a
a
a
g
g
i
i
i
i
i
i
i
g
a
a
a
"}
(28,1,1) = {"
a
a
a
a
a
a
a
a
a
a
a
a
a
a
a
a
a
a
a
a
a
a
a
a
a
a
a
a
a
a
a
a
a
a
g
g
i
i
i
i
i
i
i
i
i
i
i
i
i
g
a
a
a
a
a
a
a
a
a
a
a
a
g
i
i
i
i
i
i
i
g
i
i
i
i
i
i
i
i
i
i
i
i
i
i
i
i
i
i
i
i
i
i
i
i
H
i
G
i
i
i
g
a
a
a
a
a
a
a
a
g
g
i
i
i
i
i
g
a
a
a
a
"}
(29,1,1) = {"
a
a
a
a
a
a
a
a
a
a
a
a
a
a
a
a
a
a
a
a
a
a
a
a
a
a
a
a
a
a
a
a
a
a
g
i
i
i
i
i
i
i
i
i
i
i
i
g
g
a
a
a
a
a
a
a
a
a
a
a
a
g
i
i
i
i
i
i
i
i
i
i
i
i
i
i
i
i
i
i
i
i
i
i
i
i
i
i
i
i
i
i
i
i
i
i
i
i
i
i
g
a
a
a
a
a
a
a
a
a
a
g
g
g
i
i
g
a
a
a
a
a
"}
(30,1,1) = {"
a
a
a
a
a
a
a
a
a
a
a
a
a
a
a
a
a
a
a
a
a
a
a
a
a
a
a
a
a
a
a
a
a
a
g
i
i
i
i
i
i
i
i
i
i
g
g
a
a
a
a
a
a
a
a
a
a
a
a
a
a
g
i
i
i
i
i
i
i
i
i
i
i
i
i
i
i
i
g
g
i
i
i
i
i
i
i
i
i
i
i
i
i
i
i
i
H
i
i
g
a
a
a
a
a
a
a
a
a
a
a
a
a
g
g
i
g
a
a
a
a
a
"}
(31,1,1) = {"
a
a
a
a
a
a
a
a
a
a
a
a
a
a
a
a
a
a
a
a
a
a
a
a
a
a
a
a
a
a
a
a
a
g
g
i
i
i
i
i
i
i
i
i
g
a
a
a
a
a
a
a
a
a
a
a
a
a
a
a
g
i
i
i
i
i
i
i
i
i
i
i
i
i
i
i
i
g
g
g
g
g
g
i
i
i
i
i
i
i
i
i
i
i
i
i
i
i
g
a
a
a
a
a
a
a
a
a
a
a
a
a
a
g
g
i
g
a
a
a
a
a
"}
(32,1,1) = {"
a
a
a
a
a
a
a
a
a
a
a
a
a
a
a
a
a
a
a
a
a
a
a
a
a
a
a
a
a
a
a
a
g
g
i
i
i
i
i
i
i
i
i
i
g
a
a
a
a
a
a
a
a
a
a
a
a
a
a
g
i
i
i
i
i
i
i
i
i
i
i
i
i
i
i
g
g
g
a
a
a
a
g
g
g
g
g
g
i
i
i
i
i
i
i
i
i
g
a
a
a
a
a
a
a
a
a
a
a
a
a
a
g
g
i
i
g
a
a
a
a
a
"}
(33,1,1) = {"
a
a
a
a
a
a
a
a
a
a
a
a
a
a
a
a
a
a
a
a
a
a
a
a
a
a
a
a
a
a
a
a
g
i
i
i
i
i
i
i
i
i
i
i
i
g
g
a
a
a
a
a
a
a
a
a
a
g
g
i
i
i
i
i
i
i
i
i
i
i
i
i
i
g
g
g
a
a
a
a
a
g
g
g
g
g
i
i
i
i
i
i
i
i
i
i
g
a
a
a
a
a
a
a
a
a
a
a
a
a
g
g
g
i
i
i
i
g
a
a
a
a
"}
(34,1,1) = {"
a
a
a
a
a
a
a
a
a
a
a
a
a
a
a
a
a
a
a
a
a
a
a
a
a
a
a
a
a
a
g
g
g
i
i
i
i
i
i
i
i
i
i
i
i
i
i
g
g
g
g
g
g
g
g
g
g
i
i
i
i
i
i
i
i
i
i
i
i
i
g
g
g
g
a
a
a
a
a
a
g
g
i
i
i
i
i
i
i
i
i
i
i
i
i
g
a
a
a
a
a
a
a
a
a
a
a
a
a
a
g
i
i
i
i
i
i
g
a
a
a
a
"}
(35,1,1) = {"
a
a
a
a
a
a
a
a
a
a
a
a
a
a
a
a
a
a
a
a
a
a
a
a
a
a
a
a
g
g
g
i
i
i
i
i
i
i
i
i
i
i
i
i
i
i
i
i
i
i
i
i
i
i
i
i
i
i
i
i
i
i
i
i
i
i
i
i
i
g
g
a
a
a
a
a
a
a
g
g
g
i
i
i
i
i
i
i
i
i
i
i
i
i
g
a
a
a
a
a
a
a
a
a
a
a
a
a
a
g
g
i
i
i
i
i
i
i
g
a
a
a
"}
(36,1,1) = {"
a
a
a
a
a
a
a
a
a
a
a
a
a
a
a
a
a
a
a
a
a
a
a
a
a
a
a
g
g
i
i
i
i
i
i
i
i
i
i
i
i
i
i
i
i
i
i
i
i
i
i
i
i
i
i
i
i
i
i
i
i
i
i
i
i
i
i
i
i
g
a
a
a
a
a
a
a
g
g
i
i
i
i
i
i
i
i
i
i
i
i
i
i
g
a
a
a
a
a
a
a
a
a
a
a
a
a
a
a
g
i
i
i
i
i
i
i
i
g
a
a
a
"}
(37,1,1) = {"
a
a
a
a
a
a
a
a
a
a
a
a
a
a
a
a
a
a
a
a
a
a
a
a
a
a
g
g
i
i
i
i
i
i
i
i
i
i
i
i
i
i
i
i
i
i
i
i
i
i
i
i
i
i
i
i
i
i
i
i
i
i
i
i
i
i
i
g
g
g
a
a
a
a
a
a
g
g
i
i
i
i
i
i
i
i
i
i
i
i
i
i
g
a
a
a
a
a
a
a
a
a
a
a
a
a
a
a
a
g
i
i
i
i
i
i
i
g
a
a
a
a
"}
(38,1,1) = {"
a
a
a
a
a
a
a
a
a
a
a
a
a
a
a
a
a
a
a
a
a
a
a
a
a
g
g
i
i
i
i
i
i
i
i
i
i
i
i
i
i
i
i
i
i
i
i
i
i
i
i
i
i
i
i
i
i
i
i
i
i
i
i
i
i
i
g
g
a
a
a
a
a
a
a
a
g
i
i
i
i
i
i
i
i
i
i
i
i
i
i
i
g
a
a
a
a
a
a
a
a
a
a
a
a
a
a
a
g
g
i
i
i
i
i
i
i
g
a
a
a
a
"}
(39,1,1) = {"
a
a
a
a
a
a
a
a
a
a
a
a
a
a
a
a
a
a
a
a
a
a
a
a
a
g
i
i
i
i
i
i
i
i
i
i
i
i
i
i
i
i
i
i
i
i
i
i
i
i
i
i
i
i
i
i
i
i
i
i
i
i
i
i
i
g
g
a
a
a
a
a
a
a
a
a
g
i
i
i
i
i
i
i
i
i
i
i
i
i
i
g
a
a
a
a
a
a
a
a
a
a
a
a
g
g
g
g
g
i
i
i
i
i
i
g
g
a
a
a
a
a
"}
(40,1,1) = {"
a
a
a
a
a
a
a
a
a
a
a
a
a
a
a
a
a
a
a
a
a
a
a
a
a
g
i
i
i
i
i
i
i
i
i
i
i
i
i
i
i
i
i
i
i
i
i
i
i
i
i
i
i
i
i
i
i
i
i
i
i
i
i
i
g
g
a
a
a
a
a
a
a
a
a
a
g
i
i
i
i
i
i
i
i
i
i
i
i
i
g
a
a
a
a
a
a
a
a
a
a
a
g
g
g
i
i
i
i
i
i
i
i
i
g
a
a
a
a
a
a
a
"}
(41,1,1) = {"
a
a
a
a
a
a
a
a
a
a
a
a
a
a
a
a
a
a
a
a
a
a
a
a
g
g
i
i
i
i
i
i
i
i
i
i
i
i
i
i
i
i
i
i
i
i
i
i
i
i
i
i
i
i
i
i
i
i
i
i
i
i
g
g
g
a
a
a
a
a
a
a
a
a
a
a
g
i
i
i
i
i
i
i
i
i
i
i
i
g
a
g
g
g
g
g
g
g
a
a
a
g
g
i
i
i
i
i
i
i
i
i
i
g
a
a
a
a
a
a
a
a
"}
(42,1,1) = {"
a
a
a
a
a
a
a
a
a
a
a
a
a
a
a
a
a
a
a
a
a
a
a
a
g
i
i
i
i
i
i
i
i
i
i
i
i
i
i
i
i
i
i
i
i
i
i
i
i
i
i
i
i
i
i
i
i
i
i
i
g
g
g
a
a
a
a
a
a
a
a
a
a
a
a
g
g
i
i
i
i
i
i
i
i
i
i
i
g
a
a
g
i
i
i
i
i
g
g
g
g
g
i
i
i
i
i
i
i
i
i
i
g
a
a
a
a
a
a
a
a
a
"}
(43,1,1) = {"
a
a
a
a
a
a
a
a
a
a
a
a
a
a
a
a
a
a
a
a
a
a
a
g
g
i
i
i
i
i
i
i
i
i
i
i
i
i
i
i
i
i
i
i
i
i
i
i
i
i
i
i
i
i
i
i
i
g
g
g
g
a
a
a
a
a
a
a
a
a
a
a
a
a
a
g
i
i
i
i
i
i
i
i
i
i
i
g
a
a
g
g
i
i
i
i
i
i
i
i
i
i
i
i
i
i
i
i
i
i
i
i
g
a
a
a
a
a
a
a
a
a
"}
(44,1,1) = {"
a
a
a
a
a
a
a
a
a
a
a
a
a
a
a
a
a
a
a
a
a
a
a
g
i
i
i
i
i
i
i
i
i
i
i
i
i
i
i
i
i
i
i
i
i
i
i
i
i
i
i
i
i
i
i
g
g
g
a
a
a
a
a
a
a
a
a
a
a
a
a
a
a
a
a
g
i
i
i
i
i
i
i
i
i
i
g
a
g
g
g
i
i
i
i
i
i
i
i
i
i
i
i
i
i
i
g
g
g
g
g
g
a
a
a
a
a
a
a
a
a
a
"}
(45,1,1) = {"
a
a
a
a
a
a
a
a
a
a
a
a
a
a
a
a
a
a
a
a
a
a
a
g
i
i
i
i
i
i
i
i
i
i
i
i
i
i
i
i
i
i
i
i
g
g
g
g
g
g
g
g
g
g
g
g
a
a
a
a
a
a
a
a
a
a
a
a
a
a
a
a
a
a
a
g
i
i
i
i
i
i
i
i
i
g
g
g
g
i
i
i
i
i
i
i
i
i
i
i
i
i
i
g
g
g
a
a
a
a
a
a
a
a
a
a
a
a
a
a
a
a
"}
(46,1,1) = {"
a
a
a
a
a
a
a
a
a
a
a
a
a
a
a
a
a
a
a
a
a
a
a
g
i
i
i
i
i
i
i
i
i
i
i
i
i
i
i
i
i
i
i
g
g
a
a
a
a
a
a
a
a
a
a
a
a
a
a
a
a
a
a
a
a
a
a
a
a
a
a
a
a
a
a
g
i
i
i
i
i
i
i
i
i
g
g
i
i
i
i
i
i
i
i
i
i
i
i
i
g
g
g
a
a
a
a
a
a
a
a
a
a
a
a
a
a
a
a
a
a
a
"}
(47,1,1) = {"
a
a
a
a
a
a
a
a
a
a
a
a
a
a
a
a
a
a
a
a
a
a
a
g
i
i
i
i
i
i
i
i
i
i
i
i
i
i
i
i
i
i
g
g
a
a
a
a
a
a
a
a
a
a
a
a
a
a
a
a
a
a
a
a
a
a
a
a
a
a
a
a
a
a
a
g
i
i
i
i
i
i
i
i
g
g
g
i
i
i
i
i
i
i
i
i
i
i
i
g
a
a
a
a
a
a
a
a
a
a
a
a
a
a
a
a
a
a
a
a
a
a
"}
(48,1,1) = {"
a
a
a
a
a
a
a
a
a
a
a
a
a
a
a
a
a
a
a
a
a
a
g
g
i
i
i
i
i
i
i
i
i
i
i
i
i
i
i
i
i
i
g
a
a
a
a
a
a
a
a
a
a
a
a
a
a
a
a
a
a
a
a
a
a
a
a
a
a
a
a
a
a
a
g
g
i
i
i
i
i
i
i
i
g
g
i
i
i
i
i
i
i
i
i
i
i
g
g
a
a
a
a
a
a
a
a
a
a
a
a
a
a
a
a
a
a
a
a
a
a
a
"}
(49,1,1) = {"
a
a
a
a
a
a
a
a
a
a
a
a
a
a
a
a
a
a
a
a
a
a
g
i
i
i
i
i
i
i
i
i
i
i
i
i
i
i
i
i
i
g
g
a
a
a
a
a
a
a
a
a
a
a
a
a
a
a
a
a
a
a
a
a
a
a
a
a
a
a
a
a
a
a
g
i
i
i
i
i
i
i
i
i
g
g
i
i
i
i
i
i
i
i
g
g
g
a
a
a
a
a
a
a
a
a
a
a
a
a
a
a
a
a
a
a
a
a
a
a
a
a
"}
