//MAP CONVERTED BY dmm2tgm.py THIS HEADER COMMENT PREVENTS RECONVERSION, DO NOT REMOVE
"a" = (
/turf/closed/indestructible/rock,
/area/city/outskirts)
"b" = (
/obj/structure/lattice/catwalk{
	resistance_flags = 115
	},
/obj/structure/railing{
	dir = 1;
	resistance_flags = 115
	},
/turf/open/floor/fakepit,
/area/city/outskirts)
"c" = (
/obj/structure/lattice/catwalk{
	resistance_flags = 115
	},
/obj/structure/railing/corner{
	dir = 8
	},
/turf/open/floor/fakepit,
/area/city/outskirts)
"d" = (
/obj/structure/railing{
	dir = 9;
	resistance_flags = 115
	},
/turf/open/floor/plating/asteroid,
/area/city/outskirts)
"e" = (
/obj/structure/lattice/catwalk{
	resistance_flags = 115
	},
/obj/structure/railing/corner{
	dir = 8;
	name = "wing-grade railing"
	},
/turf/open/floor/fakepit,
/area/city/outskirts)
"g" = (
/obj/structure/railing/corner{
	dir = 4
	},
/turf/open/floor/plating/asteroid,
/area/city/outskirts)
"h" = (
/obj/effect/landmark/abnospawn/easysupport,
/obj/structure/railing/corner{
	dir = 8
	},
/turf/open/floor/plating/asteroid,
/area/city/outskirts)
"i" = (
/turf/open/floor/plating/asteroid,
/area/city/outskirts)
"j" = (
/obj/structure/railing{
	dir = 5
	},
/turf/open/floor/plating/asteroid,
/area/city/outskirts)
"k" = (
/obj/structure/lattice/catwalk{
	resistance_flags = 115
	},
/obj/structure/railing{
	dir = 8;
	resistance_flags = 115
	},
/turf/open/floor/fakepit,
/area/city/outskirts)
"m" = (
/obj/effect/landmark/abnospawn/easycombat,
/turf/open/floor/plating/asteroid,
/area/city/outskirts)
"o" = (
/obj/structure/lattice/catwalk{
	resistance_flags = 115
	},
/obj/structure/railing/corner,
/turf/open/floor/fakepit,
/area/city/outskirts)
"p" = (
/obj/structure/railing{
	dir = 10;
	resistance_flags = 115
	},
/turf/open/floor/plating/asteroid,
/area/city/outskirts)
"s" = (
/obj/structure/railing{
	dir = 8;
	resistance_flags = 115
	},
/turf/open/floor/plating/asteroid,
/area/city/outskirts)
"t" = (
/obj/structure/railing/corner{
	dir = 8;
	name = "wing-grade railing"
	},
/turf/open/floor/plating/asteroid,
/area/city/outskirts)
"u" = (
/obj/structure/railing,
/turf/open/floor/plating/asteroid,
/area/city/outskirts)
"v" = (
/obj/structure/railing/corner{
	dir = 1
	},
/turf/open/floor/plating/asteroid,
/area/city/outskirts)
"x" = (
/obj/structure/railing/corner{
	dir = 8
	},
/turf/open/floor/plating/asteroid,
/area/city/outskirts)
"y" = (
/obj/structure/railing{
	dir = 1;
	resistance_flags = 115
	},
/turf/open/floor/plating/asteroid,
/area/city/outskirts)
"z" = (
/obj/structure/lattice/catwalk{
	resistance_flags = 115
	},
/obj/structure/lattice/catwalk{
	resistance_flags = 115
	},
/turf/open/floor/fakepit,
/area/city/outskirts)
"C" = (
/obj/effect/landmark/abnospawn/easytank,
/turf/open/floor/plating/asteroid,
/area/city/outskirts)
"D" = (
/obj/structure/railing{
	resistance_flags = 115
	},
/turf/open/floor/plating/asteroid,
/area/city/outskirts)
"E" = (
/obj/structure/railing/corner{
	dir = 1;
	name = "wing-grade railing"
	},
/turf/open/floor/plating/asteroid,
/area/city/outskirts)
"G" = (
/obj/effect/landmark/abnospawn/easysupport,
/turf/open/floor/plating/asteroid,
/area/city/outskirts)
"H" = (
/obj/structure/lattice/catwalk{
	resistance_flags = 115
	},
/turf/open/floor/fakepit,
/area/city/outskirts)
"I" = (
/obj/structure/lattice/catwalk{
	resistance_flags = 115
	},
/obj/structure/railing/corner{
	dir = 1;
	name = "wing-grade railing"
	},
/turf/open/floor/fakepit,
/area/city/outskirts)
"K" = (
/turf/open/chasm,
/area/city/outskirts)
"L" = (
/obj/structure/lattice/catwalk{
	resistance_flags = 115
	},
/obj/structure/railing{
	dir = 9;
	resistance_flags = 115
	},
/turf/open/floor/fakepit,
/area/city/outskirts)
"O" = (
/obj/structure/lattice/catwalk{
	resistance_flags = 115
	},
/obj/structure/railing/corner{
	dir = 1
	},
/turf/open/floor/fakepit,
/area/city/outskirts)
"Q" = (
/obj/structure/lattice/catwalk{
	resistance_flags = 115
	},
/obj/structure/railing{
	dir = 4;
	resistance_flags = 115
	},
/turf/open/floor/fakepit,
/area/city/outskirts)
"R" = (
/obj/effect/landmark/nobasic_incorp_move,
/turf/open/chasm,
/area/city/outskirts)
"T" = (
/obj/structure/lattice/catwalk{
	resistance_flags = 115
	},
/obj/structure/railing{
	resistance_flags = 115
	},
/turf/open/floor/fakepit,
/area/city/outskirts)
"U" = (
/obj/effect/landmark/nobasic_incorp_move,
/turf/closed/indestructible/rock,
/area/city/outskirts)
"V" = (
/obj/structure/lattice/catwalk{
	resistance_flags = 115
	},
/obj/structure/railing/corner{
	dir = 4;
	name = "wing-grade railing"
	},
/turf/open/floor/fakepit,
/area/city/outskirts)
"X" = (
/obj/structure/lattice/catwalk{
	resistance_flags = 115
	},
/obj/structure/railing{
	dir = 6;
	resistance_flags = 115
	},
/turf/open/floor/fakepit,
/area/city/outskirts)
"Y" = (
/obj/structure/lattice/catwalk{
	resistance_flags = 115
	},
/obj/structure/railing/corner{
	dir = 4
	},
/turf/open/floor/fakepit,
/area/city/outskirts)

(1,1,1) = {"
a
a
a
a
a
a
a
a
a
a
a
a
a
a
a
a
a
a
a
a
a
a
a
a
a
a
a
a
a
a
a
a
a
a
a
a
a
a
a
a
a
a
a
a
a
a
a
a
a
a
a
a
a
a
a
a
a
a
a
a
a
a
a
a
a
a
a
a
a
a
a
a
a
a
a
a
a
a
a
a
a
a
a
a
a
a
a
a
a
a
a
a
a
a
a
a
a
a
a
a
a
a
a
a
a
a
a
a
a
a
a
a
a
a
a
a
a
a
a
a
a
a
"}
(2,1,1) = {"
a
a
a
a
a
a
a
a
a
a
a
a
a
a
a
a
a
a
a
a
a
a
a
a
a
a
a
a
a
a
a
a
a
a
a
a
a
a
a
a
a
a
a
a
a
a
a
a
a
a
a
a
a
a
a
a
a
a
a
a
a
a
a
a
a
a
a
a
a
a
a
a
a
a
a
a
a
a
a
a
a
a
a
a
a
a
a
a
a
a
a
a
a
a
a
a
a
a
a
a
a
a
a
a
a
a
a
a
a
a
a
a
a
a
a
a
a
a
a
a
a
a
"}
(3,1,1) = {"
a
a
a
a
a
a
a
a
a
a
a
a
a
a
a
a
a
a
a
a
a
a
a
a
a
a
a
a
a
a
a
a
a
a
a
a
a
a
a
a
a
a
a
a
a
a
a
a
a
a
a
a
a
a
a
a
a
a
a
a
a
a
a
a
a
a
a
a
a
a
a
a
a
a
a
a
a
a
a
a
a
a
a
a
a
a
a
a
a
a
a
a
a
a
a
a
a
a
a
a
a
a
a
a
a
a
a
a
a
a
a
a
a
a
a
a
a
a
a
a
a
a
"}
(4,1,1) = {"
a
a
a
a
a
a
a
a
a
a
a
a
a
a
a
a
a
a
a
a
a
a
a
a
a
a
a
a
a
a
a
a
a
a
a
a
a
a
a
a
a
a
a
a
a
a
a
a
a
a
a
a
a
a
a
a
a
a
a
a
a
a
a
a
a
a
a
a
a
a
a
a
a
a
a
a
a
a
a
a
a
a
a
a
a
a
a
a
a
a
a
a
a
a
a
a
a
a
a
a
a
a
a
a
a
a
a
a
a
a
a
a
a
a
a
a
a
a
a
a
a
a
"}
(5,1,1) = {"
a
a
a
a
a
a
a
a
a
a
a
a
a
a
a
a
a
a
a
a
a
a
a
a
a
a
a
a
a
a
a
a
a
a
a
a
a
a
a
a
a
a
a
a
a
a
a
a
a
a
a
a
a
a
a
a
a
a
a
a
a
a
a
a
a
a
a
a
a
a
a
a
a
a
a
a
a
a
a
a
a
a
a
a
a
a
a
a
a
a
a
a
a
a
a
a
a
a
a
a
a
a
a
a
a
a
a
a
a
a
a
a
a
a
a
a
a
a
a
a
a
a
"}
(6,1,1) = {"
a
a
a
a
a
a
a
a
a
a
a
a
a
a
a
a
a
a
a
a
a
a
a
a
a
a
a
a
a
a
a
a
a
a
a
a
a
a
a
a
a
a
a
a
a
a
a
a
a
a
a
a
a
a
a
a
a
a
a
a
a
a
a
a
a
a
a
a
a
a
a
a
a
a
a
a
a
a
a
a
a
a
a
a
a
a
a
a
a
a
a
a
a
a
a
a
a
a
a
a
a
a
a
a
a
a
a
a
a
a
a
a
a
a
a
a
a
a
a
a
a
a
"}
(7,1,1) = {"
a
a
a
a
a
a
a
a
a
a
a
a
a
a
a
a
a
a
a
a
a
a
a
a
a
a
a
a
a
a
a
a
a
a
a
a
a
a
a
a
a
a
a
a
a
a
a
a
a
a
a
a
a
a
a
a
a
a
a
a
a
a
a
a
a
a
a
a
a
a
a
a
a
a
a
a
a
a
a
a
a
a
a
a
a
a
a
a
a
a
K
K
K
K
K
K
K
K
K
K
a
a
a
a
a
a
a
a
a
a
a
a
a
a
a
a
a
a
a
a
a
a
"}
(8,1,1) = {"
a
a
a
a
a
a
a
a
a
a
a
a
a
a
a
a
a
a
a
a
a
a
a
a
a
a
a
a
a
a
a
a
a
a
a
a
a
a
a
a
a
a
a
a
a
a
a
a
a
a
a
a
a
a
a
a
a
a
a
a
a
a
a
a
a
a
a
a
a
a
a
a
a
a
a
a
a
a
a
a
a
a
K
K
K
K
K
K
K
K
K
K
K
K
K
K
K
K
K
K
K
K
K
K
K
a
a
a
a
a
a
a
a
a
a
a
a
a
a
a
a
a
"}
(9,1,1) = {"
a
a
a
a
a
a
a
a
a
a
a
a
a
a
a
a
a
a
a
a
a
a
a
a
a
a
a
a
a
a
a
a
a
a
a
a
K
K
K
K
K
K
K
K
K
a
a
a
a
a
a
a
a
a
a
a
a
a
a
a
a
a
a
a
a
a
a
K
K
K
K
K
K
K
K
K
K
K
K
K
K
K
K
K
K
K
K
K
K
K
K
K
K
K
K
K
K
K
K
K
K
K
K
K
K
K
K
K
K
K
K
K
K
a
a
a
a
a
a
a
a
a
"}
(10,1,1) = {"
a
a
a
a
a
a
a
a
a
a
a
a
a
a
a
a
a
a
a
a
a
a
a
a
a
a
a
a
a
a
a
K
K
K
K
K
K
K
K
K
K
K
K
K
K
K
K
K
a
a
a
a
a
a
a
a
a
a
a
a
a
a
a
a
K
K
K
K
K
K
K
K
K
K
K
K
K
K
K
K
K
K
K
K
K
K
K
K
K
K
K
K
K
K
K
K
K
K
K
K
K
K
K
K
K
K
K
K
K
K
K
K
K
K
a
a
a
a
a
a
a
a
"}
(11,1,1) = {"
a
a
U
U
U
U
a
a
a
a
a
a
a
a
a
a
a
a
a
a
a
a
a
a
a
a
a
a
a
K
K
K
K
K
K
K
K
K
K
K
K
K
K
K
K
K
K
K
K
K
K
a
a
a
a
a
a
a
a
a
a
a
K
K
K
K
K
K
K
K
K
K
K
K
K
K
K
K
K
K
K
K
K
K
K
K
K
K
K
K
K
K
K
K
K
K
K
K
K
K
K
K
K
K
K
K
K
K
K
K
K
K
K
K
K
a
a
a
a
a
a
a
"}
(12,1,1) = {"
a
U
H
H
H
H
U
a
a
a
a
a
a
a
a
a
a
a
a
a
a
a
a
a
a
a
a
a
K
K
K
K
K
K
K
K
K
K
K
K
K
K
K
K
K
K
K
K
K
K
K
K
K
K
K
K
K
K
K
K
K
K
K
K
K
K
K
K
K
K
K
K
K
K
K
K
K
K
K
K
K
K
K
K
K
K
K
K
K
K
K
K
K
K
K
K
K
K
K
K
K
K
K
K
K
K
K
K
K
K
K
K
K
K
K
a
a
a
a
a
a
a
"}
(13,1,1) = {"
U
H
H
H
H
H
H
U
U
U
U
a
a
a
a
a
a
a
a
a
a
a
a
a
a
a
K
K
K
K
K
K
K
K
K
K
K
K
K
K
K
K
K
K
K
K
K
K
K
K
K
K
K
K
K
K
K
K
K
K
K
K
K
K
K
K
K
K
K
K
K
K
K
K
K
K
K
K
K
K
K
K
K
K
K
K
K
K
K
K
K
K
K
K
K
K
K
K
K
K
K
K
K
K
K
K
K
K
K
K
K
K
K
K
K
K
a
a
a
a
a
a
"}
(14,1,1) = {"
U
H
H
H
H
H
H
H
H
H
H
U
a
a
a
a
a
a
a
a
a
a
a
a
a
K
K
K
K
K
K
K
K
K
K
K
K
K
K
K
K
K
K
K
K
K
K
K
K
K
K
K
K
K
K
K
K
K
K
K
K
K
K
K
K
K
K
K
K
K
K
K
K
K
K
K
K
K
K
K
K
K
K
K
K
K
K
K
K
K
K
K
K
K
K
K
K
K
K
K
K
K
K
K
K
K
K
K
K
K
K
K
K
K
K
a
a
a
a
a
a
a
"}
(15,1,1) = {"
U
H
H
H
H
H
H
H
H
H
H
U
U
U
U
U
U
U
U
U
a
a
a
a
K
K
K
K
K
K
K
K
K
K
K
K
K
K
K
K
K
K
K
K
K
K
K
K
K
K
K
K
K
K
K
K
K
K
K
K
K
K
K
K
K
K
K
K
K
K
K
K
K
K
K
K
K
K
K
K
K
K
K
K
K
K
K
K
K
K
K
K
K
K
K
K
K
K
K
K
K
K
K
K
K
K
K
K
K
K
K
K
K
K
K
U
a
a
a
a
a
a
"}
(16,1,1) = {"
U
H
H
H
H
H
H
a
a
H
H
H
H
H
H
H
H
H
H
U
a
a
a
K
K
K
K
K
K
K
K
K
K
K
K
K
K
K
K
K
K
K
K
K
K
K
K
K
K
K
K
K
K
K
K
K
K
K
K
K
K
K
K
K
K
K
K
K
K
K
K
K
K
K
K
K
K
K
K
K
K
K
K
K
K
K
K
K
K
K
K
K
K
K
K
K
K
K
K
K
K
K
K
K
K
K
K
K
K
K
K
K
K
K
R
d
U
U
a
a
a
a
"}
(17,1,1) = {"
a
U
H
H
H
H
a
a
a
H
H
H
H
H
H
H
H
H
H
U
a
a
K
K
K
K
K
K
K
K
K
K
K
K
K
K
K
K
K
K
K
K
K
K
K
K
K
K
K
K
K
K
K
K
K
K
K
K
K
K
K
K
K
K
K
K
K
K
K
K
K
K
K
K
K
K
K
K
K
K
K
K
K
K
K
K
K
K
K
K
K
K
K
K
K
K
K
K
K
K
K
K
K
K
K
K
K
K
K
K
K
K
K
R
d
E
i
i
U
U
a
a
"}
(18,1,1) = {"
a
a
U
U
U
H
a
a
a
H
H
a
a
a
a
a
a
H
H
U
a
a
K
K
K
K
K
K
K
K
K
K
K
K
K
K
K
K
K
K
K
K
K
K
K
K
K
K
K
K
K
K
K
K
K
K
K
K
K
K
K
K
K
K
K
K
K
K
K
K
K
K
K
K
K
K
K
K
K
K
K
K
K
K
K
K
K
K
K
K
K
K
K
K
K
K
K
K
K
K
K
K
K
K
K
K
K
K
K
K
K
K
R
d
E
i
i
i
i
i
U
a
"}
(19,1,1) = {"
a
a
a
U
U
H
a
a
a
H
H
a
a
a
a
a
a
H
H
U
a
K
K
K
K
K
K
K
K
K
K
K
K
K
K
K
K
K
K
K
K
K
K
K
K
K
K
K
K
K
K
K
K
K
K
K
K
K
K
K
K
K
K
K
K
K
K
K
K
K
K
K
K
K
K
K
K
K
K
K
K
K
K
K
K
K
K
K
K
K
K
K
K
K
K
K
K
K
K
K
K
K
K
K
K
K
K
K
K
K
K
R
d
v
i
i
i
i
i
i
i
U
"}
(20,1,1) = {"
a
a
U
H
H
H
a
a
a
H
H
a
a
a
a
a
a
H
H
U
a
K
K
K
K
K
K
K
K
K
K
K
K
R
R
R
R
R
R
R
R
R
R
R
R
R
R
R
R
R
R
R
R
R
R
R
R
R
R
R
R
R
R
R
R
R
R
R
R
R
R
R
R
R
R
R
R
R
R
R
R
R
R
R
R
R
R
R
R
R
R
R
R
R
R
R
R
R
R
R
R
R
R
R
R
R
R
R
R
R
R
R
y
i
i
i
i
i
i
i
i
i
"}
(21,1,1) = {"
a
a
U
H
a
a
a
a
a
H
H
a
a
a
a
a
a
H
H
U
a
K
K
K
K
K
K
K
K
K
K
K
R
L
k
k
k
k
k
k
k
k
k
k
k
k
k
k
k
k
k
k
k
k
k
k
k
k
k
k
k
k
k
k
k
k
k
k
k
k
k
k
k
k
k
k
k
k
k
k
k
k
k
k
k
k
k
k
k
k
k
k
k
k
k
k
k
k
k
k
k
k
k
k
k
k
k
k
k
k
k
s
v
i
i
i
i
i
i
i
i
i
"}
(22,1,1) = {"
a
a
U
H
a
a
a
a
a
H
H
a
a
a
a
a
a
H
H
U
a
K
K
K
K
K
K
K
K
K
K
R
L
O
H
H
H
H
H
H
H
H
H
H
H
H
H
H
H
H
H
H
H
H
H
H
H
H
H
H
H
H
H
H
H
H
H
H
H
H
H
H
H
H
H
H
H
H
H
H
H
H
H
H
H
H
H
H
H
H
H
H
H
H
H
H
H
H
H
H
H
H
H
H
H
H
H
H
H
H
H
i
i
i
i
i
i
i
i
i
i
i
"}
(23,1,1) = {"
a
a
U
H
a
a
a
a
H
H
H
H
H
H
H
H
H
H
H
U
a
K
K
K
K
K
K
K
K
K
R
L
O
H
H
H
H
H
H
H
H
H
H
H
H
H
H
H
H
H
H
H
H
H
H
H
H
H
H
H
H
H
H
H
H
H
H
H
H
H
H
H
H
H
H
H
H
H
H
H
H
H
H
H
H
H
H
H
H
H
H
H
H
H
H
H
H
H
H
H
H
H
H
H
H
H
H
H
H
H
H
i
i
i
i
i
i
i
i
i
i
i
"}
(24,1,1) = {"
a
a
U
H
a
a
a
a
H
H
H
H
H
H
H
H
H
H
H
U
a
K
K
K
K
K
K
K
K
R
L
O
H
H
H
H
H
H
H
H
H
H
H
H
H
H
H
H
H
H
H
H
H
H
H
H
H
H
H
H
H
H
H
H
H
H
H
H
H
H
H
H
H
H
H
H
H
H
H
H
H
H
H
H
H
H
H
H
H
H
H
H
H
H
H
H
H
H
H
H
H
H
H
H
H
H
H
H
H
H
H
i
i
i
i
i
i
i
i
i
i
i
"}
(25,1,1) = {"
a
a
U
H
a
a
a
a
H
H
a
a
H
H
a
a
a
H
H
U
a
K
K
K
K
K
K
K
K
R
b
H
H
H
H
H
H
o
Q
Q
Q
Q
Q
Q
Q
Q
Q
Q
Q
Q
Q
Q
Q
H
H
H
Q
Q
Q
Q
Q
Q
Q
Q
Q
Q
Q
Q
Q
Q
Q
Q
Q
Q
Q
Q
Q
Q
Q
Y
H
H
H
o
Q
Q
Q
Q
Q
Q
Q
Q
Q
Q
Q
Q
Q
Q
Q
Q
Q
Q
Q
Q
Q
Q
Q
Q
Q
Q
Q
g
i
i
i
i
i
i
i
U
i
U
"}
(26,1,1) = {"
a
U
H
H
H
H
a
a
H
H
a
a
H
H
a
a
a
H
H
U
a
K
K
K
K
K
K
K
K
R
b
H
H
H
H
H
o
X
R
R
R
R
R
R
R
R
R
R
R
R
R
R
R
b
H
T
R
R
R
R
R
R
R
R
R
R
R
R
R
R
R
R
R
R
R
R
R
R
R
b
H
H
H
T
R
R
R
R
R
R
R
R
R
R
R
R
R
R
R
R
R
R
R
R
R
R
R
R
R
R
R
j
g
i
i
i
i
i
U
a
U
a
"}
(27,1,1) = {"
U
H
H
H
H
H
H
a
H
H
a
a
H
H
a
a
a
H
H
U
a
K
K
K
K
K
K
K
K
R
b
H
H
H
H
o
X
R
K
K
K
K
K
K
K
K
K
K
K
K
K
K
R
b
H
T
R
K
K
K
K
K
K
K
K
K
K
K
K
K
K
K
K
K
K
K
K
K
R
b
H
H
H
T
R
K
K
K
K
K
K
K
K
K
K
K
K
K
K
K
K
K
K
K
K
K
K
K
K
K
K
R
j
g
i
U
U
U
a
a
a
a
"}
(28,1,1) = {"
U
H
H
H
H
H
H
H
H
H
a
a
H
H
a
a
a
H
H
U
U
R
R
R
R
R
R
R
R
R
b
H
H
H
o
X
R
K
K
K
K
K
K
K
K
K
K
K
K
K
K
K
R
b
H
T
R
K
K
K
K
K
K
K
K
K
K
K
K
K
K
K
K
K
K
K
K
K
R
b
H
H
H
T
R
K
K
K
K
K
K
K
K
K
K
K
K
K
K
K
K
K
K
K
K
K
K
K
K
K
K
K
U
U
U
a
a
a
a
a
a
a
"}
(29,1,1) = {"
U
H
H
H
H
H
H
H
H
H
a
a
H
H
a
a
a
H
H
H
c
k
k
k
k
k
k
k
k
k
I
H
H
H
T
R
K
K
K
K
K
K
K
K
K
K
K
K
K
K
K
K
R
b
H
T
R
K
K
K
K
K
K
K
K
K
K
K
K
K
K
K
K
K
K
K
K
K
R
b
H
H
H
T
R
K
K
K
K
K
K
K
K
K
K
K
K
K
K
K
K
K
K
K
K
K
K
K
K
K
K
K
K
a
a
a
a
a
a
a
a
a
"}
(30,1,1) = {"
U
H
H
H
H
H
H
a
H
H
a
a
H
H
a
a
a
H
H
H
H
H
H
H
H
H
H
H
H
H
H
H
H
H
T
R
K
K
K
K
K
K
K
K
K
K
K
K
K
K
K
K
R
b
H
T
R
K
K
K
K
K
K
K
K
K
K
K
K
K
K
K
K
K
K
K
K
K
R
b
H
H
H
T
R
K
K
K
K
K
K
K
K
K
K
K
K
K
K
K
K
K
K
K
K
K
K
K
K
K
K
K
K
K
a
a
a
a
a
a
a
a
"}
(31,1,1) = {"
a
U
H
H
H
H
a
a
H
H
a
a
H
H
a
a
a
H
H
H
o
Q
Q
Q
Q
Q
Q
Q
Q
Q
V
H
H
H
T
R
K
K
K
K
K
K
K
K
K
K
K
K
K
K
K
K
R
b
H
T
R
K
K
K
K
K
K
K
K
K
K
K
K
K
K
K
K
K
K
K
K
K
R
b
H
H
H
T
R
K
K
K
K
K
K
K
K
K
K
K
K
K
K
K
K
K
K
K
K
K
K
K
K
K
K
K
K
K
K
a
a
a
a
a
a
a
"}
(32,1,1) = {"
a
a
U
H
a
a
a
a
H
H
a
a
H
H
a
a
a
H
H
U
U
R
R
R
R
R
R
R
R
R
b
H
H
H
T
R
K
K
K
K
K
K
K
K
K
K
K
K
K
K
K
K
R
b
H
T
R
K
K
K
K
K
K
K
K
K
K
K
K
K
K
a
a
a
a
K
K
K
R
b
H
H
H
T
R
K
K
K
K
K
K
K
K
K
K
K
K
K
K
K
K
K
K
K
K
K
K
K
K
K
K
K
K
K
a
a
a
a
a
a
a
a
"}
(33,1,1) = {"
a
a
U
H
a
a
a
a
H
H
a
a
H
H
H
H
H
H
H
U
a
K
K
K
K
K
K
K
K
R
b
H
H
H
T
R
K
K
K
K
K
K
K
K
K
R
R
R
R
R
R
R
R
b
H
T
R
K
K
K
K
K
K
K
K
K
K
K
K
K
a
a
a
a
a
a
K
K
R
b
H
H
H
T
R
K
K
K
K
K
K
K
K
K
K
K
K
K
K
K
K
K
K
K
K
K
K
K
K
K
K
K
K
K
a
a
a
a
a
a
a
a
"}
(34,1,1) = {"
a
a
U
H
a
a
a
a
H
H
a
a
H
H
H
H
H
H
H
U
a
K
K
K
K
K
K
K
K
R
b
H
H
H
T
R
K
K
K
K
K
K
K
K
K
R
L
k
k
k
k
k
k
I
H
e
U
a
a
K
K
K
K
K
K
K
K
K
a
a
a
a
a
a
a
a
K
K
R
b
H
H
H
T
R
K
K
K
K
K
K
K
K
K
K
K
K
K
K
K
K
K
K
K
K
K
K
K
K
K
K
K
K
a
a
a
a
a
a
a
a
a
"}
(35,1,1) = {"
a
a
U
H
H
a
a
a
H
H
a
a
a
a
a
a
a
H
H
U
a
K
K
K
K
K
K
K
K
R
b
H
H
H
T
R
K
K
K
K
K
K
K
K
K
R
b
H
H
H
H
H
H
H
H
H
U
a
a
a
a
K
K
K
K
a
a
a
a
a
a
a
a
a
a
a
a
K
R
b
H
H
H
T
R
K
K
K
K
K
K
K
K
K
K
K
K
K
K
K
K
K
K
K
K
K
K
K
K
K
K
K
K
a
a
a
a
a
a
a
a
a
"}
(36,1,1) = {"
a
a
a
U
H
a
a
a
H
H
a
a
a
a
a
a
a
H
H
U
a
K
K
K
K
K
K
K
K
R
b
H
H
H
T
R
K
K
K
K
K
K
K
K
K
R
U
U
U
U
U
U
U
H
H
H
U
a
a
a
a
a
a
a
a
a
a
a
a
a
a
a
a
a
a
a
a
K
R
b
H
H
H
T
R
K
K
K
K
K
K
K
K
K
K
K
K
K
K
K
K
K
K
K
K
K
K
K
K
K
K
K
K
K
a
a
a
a
a
a
a
a
"}
(37,1,1) = {"
a
a
a
U
H
a
a
a
H
H
a
a
a
a
a
a
a
H
H
U
a
K
K
K
K
K
K
K
K
R
b
H
H
H
T
R
K
K
K
K
K
K
K
K
K
a
a
a
a
a
a
a
U
H
H
H
U
a
a
a
a
a
a
a
a
a
a
a
a
a
a
a
a
a
a
a
a
K
R
b
H
H
H
T
R
K
K
K
K
K
K
K
K
K
K
K
K
K
K
K
K
K
K
K
K
K
K
K
K
K
K
K
K
K
a
a
a
a
a
a
a
a
"}
(38,1,1) = {"
a
a
a
U
H
a
a
a
H
H
H
H
H
H
H
H
H
H
H
U
a
a
K
K
K
K
K
K
K
R
b
H
H
H
T
R
K
K
K
K
K
K
K
K
a
a
a
a
a
a
a
a
U
H
H
H
U
a
a
a
a
a
a
a
a
a
a
a
a
a
a
a
a
a
a
a
K
K
R
b
i
i
i
T
R
K
K
K
K
K
K
K
K
K
K
K
K
K
K
K
K
K
K
K
K
K
K
K
K
K
K
K
K
K
K
a
a
a
a
a
a
a
"}
(39,1,1) = {"
a
a
a
U
H
a
a
a
H
H
H
H
H
H
H
H
H
H
H
U
a
a
K
K
K
K
K
K
K
R
b
H
H
H
T
R
K
K
K
K
K
K
K
K
a
a
a
a
a
a
a
a
U
H
H
H
U
U
U
U
U
U
U
U
U
U
U
U
U
U
U
U
U
a
a
K
K
R
d
v
i
i
i
D
R
K
K
K
K
K
K
K
K
K
K
K
K
K
K
K
K
K
K
K
K
K
K
K
K
K
K
K
K
K
K
a
a
a
a
a
a
a
"}
(40,1,1) = {"
a
a
a
U
H
a
a
a
a
a
a
a
a
a
H
H
U
U
U
U
a
a
K
K
K
K
K
K
K
R
b
H
H
H
T
R
K
K
K
K
K
K
K
a
a
a
a
a
a
a
a
a
U
H
H
H
H
H
H
H
H
H
H
H
H
H
H
H
H
H
H
H
U
U
U
U
R
d
v
i
i
i
C
x
p
R
K
K
K
K
K
K
R
R
K
K
K
K
K
K
K
K
K
K
K
K
K
K
K
K
K
K
K
K
K
a
a
a
a
a
a
a
"}
(41,1,1) = {"
a
a
U
H
H
H
H
a
a
a
a
a
a
a
H
H
U
a
a
a
a
a
K
K
K
K
K
K
K
R
b
H
H
H
T
R
K
K
K
K
K
K
a
a
a
a
a
a
a
a
a
a
U
H
H
H
H
H
H
H
H
H
H
H
H
H
H
H
H
z
z
z
H
H
H
e
s
v
i
i
i
i
i
i
D
R
K
K
K
K
K
R
d
p
R
K
K
K
K
K
K
K
K
K
K
K
K
K
K
K
K
K
K
K
K
a
a
a
a
a
a
a
"}
(42,1,1) = {"
a
U
H
H
H
H
H
H
a
a
a
a
a
a
H
H
U
a
a
a
a
a
K
K
K
K
K
K
R
R
y
i
i
i
T
R
R
K
K
K
K
K
a
a
a
a
U
U
U
U
U
U
U
H
H
a
a
a
a
a
a
a
H
H
a
a
a
a
a
H
H
H
H
H
H
H
i
i
i
i
G
i
i
i
t
p
R
K
R
K
K
R
y
u
R
R
K
K
K
K
K
K
K
K
K
K
K
K
K
K
K
K
K
K
K
a
a
a
a
a
a
a
"}
(43,1,1) = {"
a
U
H
H
H
H
H
H
H
H
H
H
H
H
H
H
U
U
U
U
a
a
a
K
K
K
K
R
d
s
v
C
i
i
h
s
p
R
R
K
K
a
a
a
a
a
U
H
H
H
H
H
H
H
H
a
a
a
a
a
a
a
H
H
a
a
a
a
a
H
H
a
a
a
a
a
i
i
i
i
i
i
i
i
i
t
a
R
a
R
R
R
y
t
s
p
R
K
K
K
K
K
K
K
K
K
K
K
K
K
K
K
K
K
K
a
a
a
a
a
a
a
"}
(44,1,1) = {"
a
U
H
H
H
H
H
H
H
H
H
H
H
H
H
H
H
z
z
U
a
a
a
K
K
K
R
d
v
i
i
i
i
i
i
i
t
s
p
R
R
U
U
U
U
U
U
z
z
H
H
H
H
H
H
a
a
a
a
a
a
a
H
H
a
a
a
a
a
H
H
a
a
a
a
a
i
m
i
i
i
i
i
i
a
a
a
a
a
K
d
s
E
i
i
D
R
K
R
K
K
K
K
K
K
K
K
K
K
K
K
K
K
K
a
a
a
a
a
a
a
a
"}
(45,1,1) = {"
a
U
H
H
H
H
H
H
U
U
U
U
U
U
H
H
H
z
z
U
a
a
a
K
K
R
d
v
i
i
i
i
i
i
i
i
i
i
x
k
k
I
H
H
H
H
H
z
z
U
U
U
U
H
H
H
H
H
H
H
H
H
H
H
H
H
H
H
H
H
H
H
H
H
H
H
i
i
i
i
i
i
i
i
a
a
a
a
x
s
E
i
i
i
i
D
R
R
a
R
K
K
K
K
K
K
K
K
K
K
K
K
K
K
a
a
a
a
a
a
a
a
"}
(46,1,1) = {"
a
a
U
H
H
H
H
U
U
a
a
a
a
U
U
U
U
H
H
U
U
U
U
U
R
R
y
i
i
i
i
m
i
i
i
i
i
i
i
i
H
H
H
H
H
H
H
z
z
U
a
a
U
H
H
H
H
H
H
H
H
H
H
H
H
H
H
H
H
H
H
H
H
H
H
H
i
i
i
i
i
i
i
a
a
a
a
i
i
i
i
i
i
i
i
D
R
a
a
a
R
K
K
K
K
K
K
K
K
K
a
a
a
a
a
a
a
a
a
a
a
a
"}
(47,1,1) = {"
a
a
a
U
U
U
U
a
a
a
a
a
a
a
a
a
U
H
H
H
H
H
H
c
k
s
v
i
i
i
i
i
i
i
G
i
i
i
i
i
H
H
H
H
H
H
H
H
H
U
a
a
U
U
U
U
U
U
U
U
U
U
U
U
U
U
U
U
U
U
U
U
U
U
U
U
U
i
i
i
i
i
i
a
a
a
a
i
i
i
i
i
i
i
i
t
s
a
a
a
a
R
R
R
K
K
K
a
a
a
a
a
a
a
a
a
a
a
a
a
a
a
"}
(48,1,1) = {"
a
a
a
a
a
a
a
a
a
a
a
a
a
a
a
a
U
H
H
H
H
H
H
H
H
i
i
m
i
i
i
i
i
i
i
i
i
i
i
i
U
U
U
U
U
U
U
U
U
U
a
a
a
a
a
a
a
a
a
a
a
a
a
a
a
a
a
a
a
a
a
a
a
a
a
U
i
i
i
i
i
i
i
a
a
a
a
i
i
i
i
i
i
i
i
i
a
a
a
a
a
a
a
a
R
R
K
a
a
a
a
a
a
a
a
a
a
a
a
a
a
a
"}
(49,1,1) = {"
a
a
a
a
a
a
a
a
a
a
a
a
a
a
a
a
U
U
U
U
U
U
U
U
U
i
i
i
i
i
i
i
i
i
i
i
i
i
i
i
U
a
a
a
a
a
a
a
a
a
a
a
a
a
a
a
a
a
a
a
a
a
a
a
a
a
a
a
a
a
a
a
a
a
U
i
i
i
i
i
i
i
i
i
a
a
i
i
i
i
i
i
i
i
a
a
a
a
a
a
a
a
a
a
a
a
R
a
a
a
a
a
a
a
a
a
a
a
a
a
a
a
"}
