//MAP CONVERTED BY dmm2tgm.py THIS HEADER COMMENT PREVENTS RECONVERSION, DO NOT REMOVE
"bH" = (
/obj/machinery/light{
	dir = 1
	},
/turf/open/floor/plasteel/dark,
/area/city/outskirts)
"cn" = (
/obj/machinery/light{
	dir = 1
	},
/obj/effect/decal/cleanable/cobweb,
/turf/open/floor/plasteel/dark,
/area/city/outskirts)
"eo" = (
/obj/effect/decal/cleanable/dirt/dust,
/obj/effect/decal/cleanable/blood/tracks{
	dir = 8
	},
/turf/open/floor/carpet/royalblue,
/area/city/outskirts)
"eT" = (
/obj/effect/decal/cleanable/blood/gibs/old,
/turf/open/floor/plasteel/dark,
/area/city/outskirts)
"fV" = (
/obj/structure/railing{
	dir = 2
	},
/turf/open/floor/plasteel/dark,
/area/city/outskirts)
"hN" = (
/obj/machinery/light{
	dir = 1
	},
/obj/effect/decal/cleanable/cobweb/cobweb2,
/turf/open/floor/plasteel/dark,
/area/city/outskirts)
"hQ" = (
/obj/effect/decal/cleanable/blood/footprints{
	dir = 4
	},
/obj/effect/decal/cleanable/blood/tracks{
	dir = 8
	},
/obj/effect/decal/cleanable/dirt/dust,
/turf/open/floor/carpet/royalblue,
/area/city/outskirts)
"iO" = (
/turf/open/floor/carpet/royalblue,
/area/city/outskirts)
"kt" = (
/obj/structure/barricade/wooden,
/obj/structure/barricade/wooden/crude,
/turf/open/floor/plasteel/dark/side{
	dir = 1
	},
/area/city/outskirts)
"lu" = (
/obj/effect/decal/cleanable/blood/gibs/bubblegum,
/turf/open/floor/plasteel/dark,
/area/city/outskirts)
"lz" = (
/obj/structure/railing{
	dir = 2
	},
/turf/open/floor/plasteel/dark/side,
/area/city/outskirts)
"mH" = (
/obj/effect/decal/cleanable/blood/drip,
/turf/open/floor/plasteel/dark,
/area/city/outskirts)
"mU" = (
/obj/effect/decal/cleanable/blood/gibs/down,
/obj/effect/decal/cleanable/blood/tracks{
	dir = 8
	},
/turf/open/floor/carpet/royalblue,
/area/city/outskirts)
"nj" = (
/obj/effect/decal/cleanable/blood/splatter,
/turf/open/floor/plasteel/dark,
/area/city/outskirts)
"nz" = (
/obj/machinery/light{
	dir = 2
	},
/obj/effect/decal/cleanable/blood/gibs/old,
/turf/open/floor/plasteel/dark,
/area/city/outskirts)
"nL" = (
/obj/effect/decal/cleanable/dirt/dust,
/turf/closed/wall/r_wall/syndicate,
/area/city/outskirts)
"nO" = (
/obj/structure/railing{
	dir = 1
	},
/turf/open/floor/plasteel/dark/side{
	dir = 1
	},
/area/city/outskirts)
"nX" = (
/turf/closed/wall/r_wall/syndicate,
/area/city/outskirts)
"pa" = (
/obj/effect/decal/cleanable/xenoblood/xsplatter,
/turf/open/floor/carpet/royalblue,
/area/city/outskirts)
"qc" = (
/obj/structure/railing{
	dir = 4
	},
/turf/open/floor/plasteel/dark,
/area/city/outskirts)
"qh" = (
/turf/open/floor/plasteel/dark/side,
/area/city/outskirts)
"rQ" = (
/obj/effect/decal/cleanable/blood/footprints{
	dir = 4
	},
/obj/effect/decal/cleanable/blood/footprints{
	dir = 4
	},
/obj/effect/decal/cleanable/blood/tracks{
	dir = 8
	},
/turf/open/floor/carpet/royalblue,
/area/city/outskirts)
"tV" = (
/obj/effect/decal/cleanable/xenoblood/xgibs,
/turf/open/floor/carpet/royalblue,
/area/city/outskirts)
"vr" = (
/obj/effect/decal/cleanable/blood/drip,
/turf/open/floor/plasteel/dark/side,
/area/city/outskirts)
"xn" = (
/obj/effect/decal/cleanable/blood/drip,
/turf/open/floor/carpet/royalblue,
/area/city/outskirts)
"xF" = (
/obj/structure/chair/comfy/shuttle{
	dir = 4
	},
/obj/effect/decal/cleanable/blood/drip,
/turf/open/floor/plasteel/dark,
/area/city/outskirts)
"yl" = (
/obj/effect/decal/cleanable/dirt/dust,
/turf/open/floor/carpet/royalblue,
/area/city/outskirts)
"yw" = (
/turf/open/floor/plasteel/dark/side{
	dir = 1
	},
/area/city/outskirts)
"zE" = (
/obj/structure/railing{
	dir = 8
	},
/obj/effect/decal/cleanable/dirt/dust,
/turf/open/floor/plasteel/dark,
/area/city/outskirts)
"Bz" = (
/obj/effect/decal/cleanable/blood/tracks{
	dir = 9
	},
/turf/open/floor/carpet/royalblue,
/area/city/outskirts)
"Ci" = (
/obj/structure/barricade/wooden,
/obj/structure/barricade/wooden/crude,
/turf/open/floor/carpet/royalblue,
/area/city/outskirts)
"Cr" = (
/obj/effect/decal/cleanable/blood/footprints{
	dir = 4
	},
/obj/effect/decal/cleanable/blood/tracks{
	dir = 8
	},
/turf/open/floor/carpet/royalblue,
/area/city/outskirts)
"Cx" = (
/obj/effect/decal/cleanable/dirt/dust,
/obj/effect/decal/cleanable/dirt/dust,
/turf/open/floor/carpet/royalblue,
/area/city/outskirts)
"CV" = (
/obj/effect/decal/cleanable/dirt/dust,
/obj/effect/decal/cleanable/blood,
/turf/open/floor/carpet/royalblue,
/area/city/outskirts)
"Eu" = (
/obj/structure/chair/comfy/shuttle{
	dir = 4
	},
/obj/effect/decal/cleanable/dirt/dust,
/turf/open/floor/plasteel/dark,
/area/city/outskirts)
"Fv" = (
/obj/structure/displaycase/trophy,
/obj/effect/decal/cleanable/dirt/dust,
/turf/open/floor/plasteel/dark,
/area/city/outskirts)
"JY" = (
/obj/effect/decal/cleanable/blood/splatter,
/turf/open/floor/plasteel/dark/side,
/area/city/outskirts)
"KK" = (
/obj/effect/decal/cleanable/blood/gibs/up,
/obj/effect/decal/cleanable/blood/bubblegum,
/turf/open/floor/plasteel/dark,
/area/city/outskirts)
"KM" = (
/obj/effect/decal/cleanable/blood/gibs/bubblegum,
/obj/effect/decal/cleanable/blood/gibs/body,
/obj/effect/decal/cleanable/blood/tracks,
/turf/open/floor/carpet/royalblue,
/area/city/outskirts)
"Lw" = (
/obj/structure/barricade/wooden,
/obj/structure/barricade/wooden/crude,
/turf/open/floor/plasteel/dark/side,
/area/city/outskirts)
"NN" = (
/obj/effect/decal/cleanable/dirt/dust,
/turf/open/floor/plasteel/dark/side,
/area/city/outskirts)
"OE" = (
/obj/machinery/light{
	dir = 2
	},
/turf/open/floor/plasteel/dark,
/area/city/outskirts)
"PA" = (
/obj/effect/decal/cleanable/blood/splatter,
/obj/effect/decal/cleanable/blood/tracks{
	dir = 6
	},
/turf/open/floor/carpet/royalblue,
/area/city/outskirts)
"Ri" = (
/obj/structure/railing{
	dir = 8
	},
/turf/open/floor/plasteel/dark,
/area/city/outskirts)
"SD" = (
/obj/structure/railing{
	dir = 1
	},
/turf/open/floor/plasteel/dark,
/area/city/outskirts)
"SZ" = (
/turf/open/floor/plasteel/dark,
/area/city/outskirts)
"Ui" = (
/obj/effect/decal/cleanable/dirt/dust,
/turf/open/floor/plasteel/dark,
/area/city/outskirts)
"Xh" = (
/obj/structure/chair/comfy/shuttle{
	dir = 4
	},
/turf/open/floor/plasteel/dark,
/area/city/outskirts)
"Xn" = (
/obj/effect/decal/cleanable/dirt/dust,
/obj/effect/decal/cleanable/blood/drip,
/turf/open/floor/plasteel/dark,
/area/city/outskirts)
"Yt" = (
/obj/structure/displaycase/trophy,
/turf/open/floor/plasteel/dark,
/area/city/outskirts)

(1,1,1) = {"
nX
cn
Ui
yw
tV
rQ
Cx
vr
SZ
OE
nX
"}
(2,1,1) = {"
nX
Xh
Xh
yw
Ci
rQ
iO
qh
Xh
Xh
nX
"}
(3,1,1) = {"
nX
SZ
lu
yw
iO
Cr
iO
JY
Xn
eT
nX
"}
(4,1,1) = {"
nX
Eu
Xh
yw
xn
hQ
iO
NN
xF
Xh
nX
"}
(5,1,1) = {"
nX
bH
mH
yw
iO
mU
iO
qh
KK
nz
nX
"}
(6,1,1) = {"
nX
SZ
qc
yw
iO
pa
iO
Lw
qc
Ui
nL
"}
(7,1,1) = {"
nX
fV
Fv
nO
iO
Ci
iO
lz
Yt
SD
nL
"}
(8,1,1) = {"
nX
SZ
Ri
kt
iO
iO
iO
qh
zE
SZ
nX
"}
(9,1,1) = {"
nX
bH
nj
yw
yl
iO
CV
qh
SZ
OE
nX
"}
(10,1,1) = {"
nX
Eu
Xh
yw
iO
Bz
KM
qh
Xh
Xh
nX
"}
(11,1,1) = {"
nX
SZ
mH
yw
Bz
PA
iO
qh
SZ
lu
nX
"}
(12,1,1) = {"
nX
Xh
Eu
yw
eo
iO
Ci
vr
Xh
Xh
nX
"}
(13,1,1) = {"
nX
hN
SZ
yw
eo
iO
iO
qh
SZ
OE
nX
"}
