//MAP CONVERTED BY dmm2tgm.py THIS HEADER COMMENT PREVENTS RECONVERSION, DO NOT REMOVE
"ah" = (
/obj/machinery/light{
	dir = 2
	},
/turf/open/floor/plasteel/dark,
/area/city/outskirts)
"bH" = (
/obj/structure/chair/comfy/shuttle{
	dir = 4
	},
/obj/effect/decal/cleanable/dirt/dust,
/turf/open/floor/plasteel/dark,
/area/city/outskirts)
"cn" = (
/obj/effect/decal/cleanable/dirt/dust,
/obj/effect/decal/cleanable/dirt/dust,
/turf/open/floor/carpet/royalblue,
/area/city/outskirts)
"eo" = (
/obj/effect/decal/cleanable/dirt/dust,
/obj/effect/decal/cleanable/blood/tracks{
	dir = 8
	},
/turf/open/floor/carpet/royalblue,
/area/city/outskirts)
"eZ" = (
/obj/effect/decal/cleanable/blood/gibs/up,
/obj/effect/decal/cleanable/blood/bubblegum,
/turf/open/floor/plasteel/dark,
/area/city/outskirts)
"fV" = (
/obj/effect/decal/cleanable/blood/drip,
/turf/open/floor/carpet/royalblue,
/area/city/outskirts)
"hz" = (
/obj/effect/decal/cleanable/xenoblood/xsplatter,
/turf/open/floor/carpet/royalblue,
/area/city/outskirts)
"hN" = (
/obj/structure/barricade/wooden,
/obj/structure/barricade/wooden/crude,
/turf/open/floor/plasteel/dark/side{
	dir = 1
	},
/area/city/outskirts)
"hQ" = (
/obj/effect/decal/cleanable/blood/footprints{
	dir = 4
	},
/obj/effect/decal/cleanable/blood/tracks{
	dir = 8
	},
/turf/open/floor/carpet/royalblue,
/area/city/outskirts)
"iO" = (
/turf/open/floor/carpet/royalblue,
/area/city/outskirts)
"kt" = (
/obj/structure/railing{
	dir = 1
	},
/turf/open/floor/plasteel/dark/side{
	dir = 1
	},
/area/city/outskirts)
"lu" = (
/obj/effect/decal/cleanable/blood/splatter,
/obj/effect/decal/cleanable/blood/tracks{
	dir = 6
	},
/turf/open/floor/carpet/royalblue,
/area/city/outskirts)
"lz" = (
/obj/structure/barricade/wooden,
/obj/structure/barricade/wooden/crude,
/turf/open/floor/plasteel/dark/side,
/area/city/outskirts)
"mH" = (
/turf/open/floor/plasteel/dark/side{
	dir = 8
	},
/area/city/outskirts)
"mU" = (
/obj/effect/decal/cleanable/blood/footprints{
	dir = 4
	},
/obj/effect/decal/cleanable/blood/tracks{
	dir = 8
	},
/obj/effect/decal/cleanable/dirt/dust,
/turf/open/floor/carpet/royalblue,
/area/city/outskirts)
"nj" = (
/obj/structure/railing{
	dir = 8
	},
/turf/open/floor/plasteel/dark,
/area/city/outskirts)
"nL" = (
/obj/effect/decal/cleanable/dirt/dust,
/turf/closed/wall/r_wall/syndicate,
/area/city/outskirts)
"nO" = (
/obj/machinery/light{
	dir = 1
	},
/obj/effect/decal/cleanable/cobweb/cobweb2,
/turf/open/floor/plasteel/dark,
/area/city/outskirts)
"nX" = (
/turf/closed/wall/r_wall/syndicate,
/area/city/outskirts)
"pa" = (
/obj/effect/decal/cleanable/blood/gibs/down,
/obj/effect/decal/cleanable/blood/tracks{
	dir = 8
	},
/turf/open/floor/carpet/royalblue,
/area/city/outskirts)
"qc" = (
/obj/effect/decal/cleanable/blood/drip,
/turf/open/floor/plasteel/dark,
/area/city/outskirts)
"qh" = (
/turf/open/floor/plasteel/dark/side,
/area/city/outskirts)
"rQ" = (
/obj/effect/decal/cleanable/blood/footprints{
	dir = 4
	},
/obj/effect/decal/cleanable/blood/footprints{
	dir = 4
	},
/obj/effect/decal/cleanable/blood/tracks{
	dir = 8
	},
/turf/open/floor/carpet/royalblue,
/area/city/outskirts)
"tR" = (
/obj/effect/decal/cleanable/blood/splatter,
/turf/open/floor/plasteel/dark,
/area/city/outskirts)
"tV" = (
/obj/structure/barricade/wooden,
/obj/structure/barricade/wooden/crude,
/turf/open/floor/plasteel/dark/corner{
	dir = 4
	},
/area/city/outskirts)
"vr" = (
/turf/open/floor/plasteel/dark/corner,
/area/city/outskirts)
"wj" = (
/obj/effect/decal/cleanable/blood/gibs/old,
/turf/open/floor/plasteel/dark,
/area/city/outskirts)
"xn" = (
/turf/open/floor/plasteel/dark/corner{
	dir = 8
	},
/area/city/outskirts)
"xF" = (
/obj/effect/decal/cleanable/dirt/dust,
/obj/effect/decal/cleanable/blood/drip,
/turf/open/floor/plasteel/dark,
/area/city/outskirts)
"yl" = (
/obj/structure/barricade/wooden,
/obj/structure/barricade/wooden/crude,
/turf/open/floor/carpet/royalblue,
/area/city/outskirts)
"yw" = (
/turf/open/floor/plasteel/dark/side{
	dir = 1
	},
/area/city/outskirts)
"zE" = (
/obj/structure/displaycase/trophy,
/turf/open/floor/plasteel/dark,
/area/city/outskirts)
"AD" = (
/obj/structure/barricade/wooden,
/obj/structure/barricade/wooden/crude,
/turf/open/floor/plasteel/dark/side{
	dir = 4
	},
/area/city/outskirts)
"Bk" = (
/obj/structure/railing{
	dir = 1
	},
/turf/open/floor/plasteel/dark,
/area/city/outskirts)
"Bz" = (
/obj/structure/barricade/wooden,
/obj/structure/barricade/wooden/crude,
/turf/open/floor/plasteel/dark/side{
	dir = 8
	},
/area/city/outskirts)
"Ci" = (
/obj/effect/decal/cleanable/xenoblood/xgibs,
/turf/open/floor/carpet/royalblue,
/area/city/outskirts)
"Cr" = (
/obj/effect/decal/cleanable/blood/tracks{
	dir = 8
	},
/turf/open/floor/carpet/royalblue,
/area/city/outskirts)
"Cx" = (
/obj/effect/decal/cleanable/dirt/dust,
/turf/open/floor/plasteel/dark/side,
/area/city/outskirts)
"CV" = (
/obj/effect/decal/cleanable/dirt/dust,
/turf/open/floor/carpet/royalblue,
/area/city/outskirts)
"Eu" = (
/turf/open/floor/plasteel/dark,
/area/city/outskirts)
"Fv" = (
/obj/structure/railing{
	dir = 4
	},
/turf/open/floor/plasteel/dark,
/area/city/outskirts)
"HE" = (
/obj/structure/railing{
	dir = 8
	},
/obj/effect/decal/cleanable/dirt/dust,
/turf/open/floor/plasteel/dark,
/area/city/outskirts)
"JY" = (
/obj/structure/railing{
	dir = 2
	},
/turf/open/floor/plasteel/dark/side,
/area/city/outskirts)
"KK" = (
/obj/structure/chair/comfy/shuttle{
	dir = 4
	},
/obj/effect/decal/cleanable/blood/drip,
/turf/open/floor/plasteel/dark,
/area/city/outskirts)
"KM" = (
/obj/effect/decal/cleanable/dirt/dust,
/obj/effect/decal/cleanable/blood,
/turf/open/floor/carpet/royalblue,
/area/city/outskirts)
"Lw" = (
/obj/effect/decal/cleanable/blood/gibs/bubblegum,
/obj/effect/decal/cleanable/blood/gibs/body,
/obj/effect/decal/cleanable/blood/tracks,
/turf/open/floor/carpet/royalblue,
/area/city/outskirts)
"Nm" = (
/obj/effect/decal/cleanable/dirt/dust,
/turf/open/floor/plasteel/dark,
/area/city/outskirts)
"NN" = (
/obj/effect/decal/cleanable/blood/splatter,
/turf/open/floor/plasteel/dark/side,
/area/city/outskirts)
"PA" = (
/obj/effect/decal/cleanable/blood/tracks{
	dir = 9
	},
/turf/open/floor/carpet/royalblue,
/area/city/outskirts)
"Ri" = (
/obj/structure/displaycase/trophy,
/obj/effect/decal/cleanable/dirt/dust,
/turf/open/floor/plasteel/dark,
/area/city/outskirts)
"Rw" = (
/turf/open/floor/plasteel/dark/side{
	dir = 4
	},
/area/city/outskirts)
"RK" = (
/obj/structure/chair/comfy/shuttle{
	dir = 4
	},
/turf/open/floor/plasteel/dark,
/area/city/outskirts)
"SY" = (
/obj/structure/railing{
	dir = 2
	},
/turf/open/floor/plasteel/dark,
/area/city/outskirts)
"SZ" = (
/obj/machinery/light{
	dir = 1
	},
/turf/open/floor/plasteel/dark,
/area/city/outskirts)
"Ui" = (
/obj/machinery/light{
	dir = 2
	},
/obj/effect/decal/cleanable/blood/gibs/old,
/turf/open/floor/plasteel/dark,
/area/city/outskirts)
"Wd" = (
/obj/effect/decal/cleanable/blood/gibs/bubblegum,
/turf/open/floor/plasteel/dark,
/area/city/outskirts)
"Xh" = (
/obj/machinery/light{
	dir = 1
	},
/obj/effect/decal/cleanable/cobweb,
/turf/open/floor/plasteel/dark,
/area/city/outskirts)
"Xn" = (
/obj/effect/decal/cleanable/blood/drip,
/turf/open/floor/plasteel/dark/side,
/area/city/outskirts)
"Yt" = (
/obj/structure/barricade/wooden,
/obj/structure/barricade/wooden/crude,
/turf/open/floor/plasteel/dark/corner{
	dir = 1
	},
/area/city/outskirts)

(1,1,1) = {"
nX
nX
Rw
tV
iO
yl
iO
vr
AD
nX
nX
"}
(2,1,1) = {"
nX
Xh
Nm
yw
Ci
rQ
cn
Xn
Eu
ah
nX
"}
(3,1,1) = {"
nX
RK
RK
yw
yl
rQ
iO
qh
RK
RK
nX
"}
(4,1,1) = {"
nX
Eu
Wd
yw
iO
hQ
iO
NN
xF
wj
nX
"}
(5,1,1) = {"
nX
bH
RK
yw
fV
mU
iO
Cx
KK
RK
nX
"}
(6,1,1) = {"
nX
SZ
qc
yw
iO
pa
iO
qh
eZ
Ui
nX
"}
(7,1,1) = {"
nX
Eu
Fv
yw
iO
hz
iO
lz
Fv
Nm
nL
"}
(8,1,1) = {"
nX
SY
Ri
kt
iO
yl
iO
JY
zE
Bk
nL
"}
(9,1,1) = {"
nX
Eu
nj
hN
iO
iO
iO
qh
HE
Eu
nX
"}
(10,1,1) = {"
nX
SZ
tR
yw
CV
iO
KM
qh
Eu
ah
nX
"}
(11,1,1) = {"
nX
bH
RK
yw
iO
PA
Lw
qh
RK
RK
nX
"}
(12,1,1) = {"
nX
Eu
qc
yw
PA
lu
iO
qh
Eu
Wd
nX
"}
(13,1,1) = {"
nX
RK
bH
yw
eo
iO
yl
Xn
RK
RK
nX
"}
(14,1,1) = {"
nX
nO
Eu
yw
eo
iO
iO
qh
Eu
ah
nX
"}
(15,1,1) = {"
nX
nX
mH
Yt
Cr
yl
iO
xn
Bz
nX
nX
"}
