//MAP CONVERTED BY dmm2tgm.py THIS HEADER COMMENT PREVENTS RECONVERSION, DO NOT REMOVE
"dV" = (
/obj/effect/turf_decal/siding/wood,
/obj/item/chair/wood/wings{
	dir = 4
	},
/obj/effect/decal/cleanable/blood/gibs/up,
/obj/effect/decal/cleanable/blood/tracks,
/obj/machinery/light,
/turf/open/floor/wood,
/area/city/outskirts)
"eT" = (
/obj/effect/turf_decal/siding/wood{
	dir = 1
	},
/obj/effect/turf_decal/siding/wood{
	dir = 4
	},
/obj/effect/turf_decal/siding/wood/corner{
	dir = 4
	},
/turf/open/floor/wood,
/area/city/outskirts)
"fu" = (
/obj/effect/turf_decal/siding/wood{
	dir = 4
	},
/obj/structure/railing{
	dir = 4
	},
/obj/effect/turf_decal/siding/wood,
/obj/effect/decal/cleanable/cobweb/cobweb2,
/turf/open/floor/wood,
/area/city/outskirts)
"fB" = (
/obj/structure/stairs/east,
/turf/open/floor/wood,
/area/city/outskirts)
"fF" = (
/obj/structure/stairs/east,
/obj/effect/turf_decal/siding/wood{
	dir = 1
	},
/turf/open/floor/wood,
/area/city/outskirts)
"fY" = (
/obj/effect/decal/cleanable/blood/gibs/up,
/obj/effect/decal/cleanable/blood/tracks,
/obj/effect/decal/cleanable/blood,
/obj/machinery/light{
	dir = 4
	},
/turf/open/floor/wood,
/area/city/outskirts)
"gI" = (
/obj/effect/turf_decal/siding/wood{
	dir = 1
	},
/obj/effect/turf_decal/siding/wood/corner{
	dir = 1
	},
/obj/effect/turf_decal/siding/wood{
	dir = 8
	},
/turf/open/floor/wood,
/area/city/outskirts)
"hc" = (
/obj/effect/mob_spawn/human/clown/corpse,
/obj/effect/decal/cleanable/blood/splatter,
/obj/effect/decal/cleanable/blood/footprints,
/turf/open/floor/wood,
/area/city/outskirts)
"iC" = (
/obj/effect/turf_decal/siding/wood/corner{
	dir = 8
	},
/turf/open/floor/wood,
/area/city/outskirts)
"jl" = (
/obj/structure/curtain/cloth/fancy,
/turf/open/floor/wood,
/area/city/outskirts)
"lW" = (
/obj/effect/turf_decal/siding/wood{
	dir = 1
	},
/turf/open/floor/wood,
/area/city/outskirts)
"pe" = (
/obj/machinery/light{
	dir = 8
	},
/turf/open/floor/wood,
/area/city/outskirts)
"qE" = (
/obj/structure/stairs/west,
/turf/open/floor/wood,
/area/city/outskirts)
"qK" = (
/obj/effect/turf_decal/siding/wood{
	dir = 8
	},
/obj/effect/decal/cleanable/dirt,
/turf/open/floor/wood,
/area/city/outskirts)
"qP" = (
/obj/effect/turf_decal/siding/wood{
	dir = 1
	},
/obj/item/chair/wood/wings{
	dir = 1
	},
/obj/effect/decal/cleanable/blood/gibs,
/turf/open/floor/wood,
/area/city/outskirts)
"sp" = (
/obj/effect/turf_decal/siding/wood/corner{
	dir = 4
	},
/obj/effect/decal/cleanable/dirt,
/turf/open/floor/wood,
/area/city/outskirts)
"sW" = (
/obj/effect/turf_decal/siding/wood,
/obj/structure/chair/wood/wings{
	dir = 1
	},
/turf/open/floor/wood,
/area/city/outskirts)
"to" = (
/obj/effect/turf_decal/siding/wood/corner{
	dir = 1
	},
/turf/open/floor/wood,
/area/city/outskirts)
"tC" = (
/obj/effect/turf_decal/siding/wood{
	dir = 9
	},
/turf/open/floor/wood,
/area/city/outskirts)
"tE" = (
/obj/effect/mob_spawn/human/clown/corpse,
/obj/effect/decal/cleanable/blood,
/obj/effect/decal/cleanable/food/pie_smudge,
/turf/open/floor/wood,
/area/city/outskirts)
"ud" = (
/obj/effect/turf_decal/siding/wood{
	dir = 5
	},
/obj/effect/decal/cleanable/dirt,
/turf/open/floor/wood,
/area/city/outskirts)
"uy" = (
/obj/effect/turf_decal/siding/wood{
	dir = 9
	},
/obj/effect/decal/cleanable/glass,
/turf/open/floor/wood,
/area/city/outskirts)
"vu" = (
/obj/effect/turf_decal/siding/wood,
/turf/open/floor/wood,
/area/city/outskirts)
"vF" = (
/obj/effect/decal/cleanable/food/pie_smudge,
/turf/open/floor/wood,
/area/city/outskirts)
"xt" = (
/obj/effect/turf_decal/siding/wood{
	dir = 1
	},
/obj/item/chair/wood/wings,
/obj/effect/decal/cleanable/blood,
/turf/open/floor/wood,
/area/city/outskirts)
"xP" = (
/obj/effect/turf_decal/siding/wood/corner{
	dir = 1
	},
/obj/effect/turf_decal/siding/wood{
	dir = 1
	},
/obj/effect/turf_decal/siding/wood/corner{
	dir = 1
	},
/turf/open/floor/wood,
/area/city/outskirts)
"zH" = (
/obj/effect/decal/cleanable/blood/tracks{
	dir = 4
	},
/obj/effect/decal/cleanable/blood,
/turf/open/floor/wood,
/area/city/outskirts)
"Ay" = (
/obj/effect/turf_decal/siding/wood{
	dir = 8
	},
/obj/structure/railing{
	dir = 8
	},
/obj/effect/turf_decal/siding/wood{
	dir = 1
	},
/turf/open/floor/wood,
/area/city/outskirts)
"Ci" = (
/obj/structure/stairs/west,
/obj/effect/turf_decal/siding/wood{
	dir = 1
	},
/turf/open/floor/wood,
/area/city/outskirts)
"Cl" = (
/obj/effect/turf_decal/siding/wood,
/obj/effect/turf_decal/siding/wood/corner{
	dir = 8
	},
/obj/effect/turf_decal/siding/wood{
	dir = 8
	},
/turf/open/floor/wood,
/area/city/outskirts)
"Cv" = (
/obj/effect/turf_decal/siding/wood/corner{
	dir = 4
	},
/obj/effect/decal/cleanable/blood/tracks,
/turf/open/floor/wood,
/area/city/outskirts)
"CT" = (
/obj/effect/turf_decal/siding/wood{
	dir = 4
	},
/obj/effect/decal/cleanable/dirt,
/turf/open/floor/wood,
/area/city/outskirts)
"Dk" = (
/obj/effect/turf_decal/siding/wood{
	dir = 8
	},
/obj/structure/railing{
	dir = 8
	},
/obj/effect/turf_decal/siding/wood,
/obj/effect/decal/cleanable/cobweb,
/turf/open/floor/wood,
/area/city/outskirts)
"EK" = (
/turf/closed/wall/r_wall/syndicate,
/area/city/outskirts)
"EO" = (
/obj/effect/decal/cleanable/blood/gibs/torso,
/obj/effect/decal/cleanable/blood/tracks,
/obj/effect/decal/cleanable/blood,
/turf/open/floor/wood,
/area/city/outskirts)
"FN" = (
/obj/effect/decal/cleanable/blood/tracks{
	dir = 9
	},
/turf/open/floor/wood,
/area/city/outskirts)
"Gj" = (
/obj/effect/decal/cleanable/blood/footprints{
	dir = 4
	},
/obj/effect/decal/cleanable/blood/footprints,
/turf/open/floor/wood,
/area/city/outskirts)
"Gn" = (
/obj/item/food/grown/tomato,
/obj/effect/decal/cleanable/food/tomato_smudge,
/turf/open/floor/wood,
/area/city/outskirts)
"Gs" = (
/obj/effect/turf_decal/siding/wood{
	dir = 4
	},
/obj/effect/decal/cleanable/glass,
/turf/open/floor/wood,
/area/city/outskirts)
"HH" = (
/obj/effect/decal/cleanable/blood/footprints{
	dir = 4
	},
/obj/effect/decal/cleanable/blood/footprints{
	dir = 4
	},
/turf/open/floor/wood,
/area/city/outskirts)
"Is" = (
/obj/effect/turf_decal/siding/wood,
/obj/effect/decal/cleanable/dirt,
/turf/open/floor/wood,
/area/city/outskirts)
"IA" = (
/obj/effect/turf_decal/siding/wood{
	dir = 10
	},
/obj/effect/decal/cleanable/glass,
/turf/open/floor/wood,
/area/city/outskirts)
"Je" = (
/obj/effect/turf_decal/siding/wood,
/obj/item/chair/wood/wings{
	dir = 8
	},
/obj/effect/decal/cleanable/blood/gibs/down,
/turf/open/floor/wood,
/area/city/outskirts)
"Js" = (
/obj/effect/turf_decal/siding/wood{
	dir = 4
	},
/obj/effect/decal/cleanable/blood/tracks,
/turf/open/floor/wood,
/area/city/outskirts)
"Jy" = (
/obj/effect/decal/cleanable/blood/footprints{
	dir = 4
	},
/turf/open/floor/wood,
/area/city/outskirts)
"KP" = (
/obj/effect/turf_decal/siding/wood{
	dir = 1
	},
/obj/effect/decal/cleanable/dirt,
/turf/open/floor/wood,
/area/city/outskirts)
"Lw" = (
/obj/effect/turf_decal/siding/wood{
	dir = 1
	},
/obj/structure/railing{
	dir = 1
	},
/turf/open/floor/wood,
/area/city/outskirts)
"OQ" = (
/obj/effect/turf_decal/siding/wood,
/obj/structure/chair/wood/wings{
	dir = 1
	},
/obj/machinery/light,
/turf/open/floor/wood,
/area/city/outskirts)
"Qa" = (
/obj/effect/turf_decal/siding/wood/corner{
	dir = 4
	},
/obj/effect/turf_decal/siding/wood{
	dir = 1
	},
/obj/effect/turf_decal/siding/wood/corner{
	dir = 4
	},
/turf/open/floor/wood,
/area/city/outskirts)
"Qe" = (
/obj/effect/decal/cleanable/blood/gibs/down,
/obj/effect/decal/cleanable/blood,
/turf/open/floor/wood,
/area/city/outskirts)
"QA" = (
/obj/effect/turf_decal/siding/wood{
	dir = 1
	},
/obj/structure/chair/wood/wings{
	dir = 1
	},
/turf/open/floor/wood,
/area/city/outskirts)
"QU" = (
/obj/effect/turf_decal/siding/wood{
	dir = 1
	},
/obj/machinery/light{
	dir = 1
	},
/turf/open/floor/wood,
/area/city/outskirts)
"SC" = (
/obj/effect/turf_decal/siding/wood{
	dir = 8
	},
/turf/open/floor/wood,
/area/city/outskirts)
"SJ" = (
/obj/effect/turf_decal/siding/wood{
	dir = 6
	},
/turf/open/floor/wood,
/area/city/outskirts)
"WP" = (
/turf/open/floor/wood,
/area/city/outskirts)
"Xj" = (
/obj/effect/turf_decal/siding/wood,
/obj/effect/turf_decal/siding/wood{
	dir = 4
	},
/obj/effect/turf_decal/siding/wood/corner,
/turf/open/floor/wood,
/area/city/outskirts)
"Yg" = (
/obj/effect/turf_decal/siding/wood{
	dir = 4
	},
/obj/structure/railing{
	dir = 4
	},
/obj/effect/turf_decal/siding/wood{
	dir = 1
	},
/turf/open/floor/wood,
/area/city/outskirts)
"YL" = (
/obj/effect/turf_decal/siding/wood/corner,
/obj/effect/decal/cleanable/blood/tracks,
/turf/open/floor/wood,
/area/city/outskirts)
"YO" = (
/obj/effect/turf_decal/siding/wood{
	dir = 4
	},
/turf/open/floor/wood,
/area/city/outskirts)
"ZO" = (
/obj/effect/turf_decal/siding/wood{
	dir = 5
	},
/turf/open/floor/wood,
/area/city/outskirts)

(1,1,1) = {"
EK
uy
SC
SC
SC
SC
SC
SC
qK
IA
EK
"}
(2,1,1) = {"
EK
eT
sp
fY
YL
Js
Cv
EO
WP
vu
EK
"}
(3,1,1) = {"
EK
fF
Yg
EK
fu
fB
Qa
tC
SC
Cl
EK
"}
(4,1,1) = {"
EK
KP
WP
jl
WP
Gn
Lw
QA
FN
dV
EK
"}
(5,1,1) = {"
EK
QU
vF
jl
hc
Gj
Lw
xt
zH
sW
EK
"}
(6,1,1) = {"
EK
lW
WP
jl
Gn
Jy
Lw
lW
Qe
vu
EK
"}
(7,1,1) = {"
EK
lW
WP
jl
WP
HH
Lw
QA
WP
Je
EK
"}
(8,1,1) = {"
EK
lW
WP
jl
WP
Jy
Lw
lW
WP
Is
EK
"}
(9,1,1) = {"
EK
QU
WP
jl
Gn
tE
Lw
qP
WP
sW
EK
"}
(10,1,1) = {"
EK
lW
WP
jl
vF
WP
Lw
QA
WP
OQ
EK
"}
(11,1,1) = {"
EK
Ci
Ay
EK
Dk
qE
xP
ud
YO
Xj
EK
"}
(12,1,1) = {"
EK
gI
to
pe
iC
SC
to
WP
WP
vu
EK
"}
(13,1,1) = {"
EK
ZO
YO
YO
YO
CT
Gs
YO
YO
SJ
EK
"}
