//MAP CONVERTED BY dmm2tgm.py THIS HEADER COMMENT PREVENTS RECONVERSION, DO NOT REMOVE
"a" = (
/turf/closed/wall/r_wall/syndicate,
/area/space)
"b" = (
/obj/structure/flora/ausbushes/fernybush,
/turf/open/floor/holofloor/grass,
/area/space)
"c" = (
/obj/effect/turf_decal/trimline/green/filled/line{
	dir = 1
	},
/obj/effect/turf_decal/trimline/green/filled/corner{
	dir = 8
	},
/obj/effect/turf_decal/trimline/green/filled/corner,
/obj/effect/decal/cleanable/blood/tracks{
	dir = 5
	},
/obj/machinery/light{
	dir = 1
	},
/turf/open/floor/plasteel/dark,
/area/space)
"d" = (
/obj/effect/turf_decal/trimline/green/filled/line,
/obj/effect/turf_decal/trimline/green/filled/corner{
	dir = 1
	},
/obj/effect/turf_decal/trimline/green/filled/corner{
	dir = 4
	},
/obj/machinery/light,
/turf/open/floor/plasteel/dark,
/area/space)
"e" = (
/obj/structure/railing{
	dir = 4
	},
/turf/open/floor/holofloor/grass,
/area/space)
"f" = (
/obj/structure/railing{
	dir = 6
	},
/turf/open/floor/holofloor/grass,
/area/space)
"g" = (
/obj/effect/turf_decal/trimline/green/filled/line{
	dir = 8
	},
/obj/effect/turf_decal/trimline/green/filled/corner{
	dir = 4
	},
/obj/effect/turf_decal/trimline/green/filled/corner,
/turf/open/floor/plasteel/dark,
/area/space)
"h" = (
/obj/effect/turf_decal/trimline/green/filled/line{
	dir = 1
	},
/obj/effect/turf_decal/trimline/green/filled/line,
/turf/open/floor/plasteel/dark,
/area/space)
"i" = (
/obj/structure/flora/ausbushes,
/turf/open/floor/holofloor/grass,
/area/space)
"j" = (
/obj/effect/turf_decal/trimline/green/filled/line{
	dir = 4
	},
/obj/effect/turf_decal/trimline/green/filled/line{
	dir = 8
	},
/turf/open/floor/plasteel/dark,
/area/space)
"k" = (
/obj/effect/turf_decal/trimline/green/filled/line{
	dir = 1
	},
/obj/effect/turf_decal/trimline/green/filled/line,
/obj/effect/decal/cleanable/blood/gibs/core,
/obj/effect/decal/cleanable/blood/tracks{
	dir = 8
	},
/turf/open/floor/plasteel/dark,
/area/space)
"l" = (
/obj/effect/turf_decal/trimline/green/filled/line{
	dir = 1
	},
/obj/effect/turf_decal/trimline/green/filled/line,
/obj/effect/decal/cleanable/blood,
/turf/open/floor/plasteel/dark,
/area/space)
"m" = (
/turf/open/floor/holofloor/grass,
/area/space)
"n" = (
/obj/structure/flora/ausbushes/stalkybush,
/obj/structure/railing{
	dir = 6
	},
/turf/open/floor/holofloor/grass,
/area/space)
"o" = (
/obj/structure/flora/ausbushes/stalkybush,
/turf/open/floor/holofloor/grass,
/area/space)
"p" = (
/obj/structure/flora/ausbushes/ywflowers,
/turf/open/floor/holofloor/grass,
/area/space)
"q" = (
/obj/effect/turf_decal/trimline/green/filled/line{
	dir = 4
	},
/obj/effect/turf_decal/trimline/green/filled/corner{
	dir = 8
	},
/obj/effect/turf_decal/trimline/green/filled/corner{
	dir = 1
	},
/turf/open/floor/plasteel/dark,
/area/space)
"r" = (
/obj/structure/flora/ausbushes/leafybush,
/turf/open/floor/holofloor/grass,
/area/space)
"s" = (
/obj/effect/turf_decal/trimline/green/filled/line,
/obj/effect/turf_decal/trimline/green/filled/corner{
	dir = 1
	},
/obj/effect/turf_decal/trimline/green/filled/corner{
	dir = 4
	},
/obj/effect/decal/cleanable/oil,
/obj/effect/decal/cleanable/shreds,
/obj/machinery/light,
/turf/open/floor/plasteel/dark,
/area/space)
"t" = (
/obj/structure/railing{
	dir = 9
	},
/turf/open/floor/holofloor/grass,
/area/space)
"u" = (
/obj/structure/railing{
	dir = 10
	},
/obj/effect/decal/cleanable/blood,
/turf/open/floor/holofloor/grass,
/area/space)
"v" = (
/obj/effect/turf_decal/trimline/green/filled/line{
	dir = 1
	},
/obj/effect/turf_decal/trimline/green/filled/line,
/obj/effect/decal/cleanable/blood,
/obj/effect/decal/cleanable/blood/tracks{
	dir = 4
	},
/turf/open/floor/plasteel/dark,
/area/space)
"w" = (
/obj/structure/flora/ausbushes/leafybush,
/obj/structure/railing{
	dir = 6
	},
/turf/open/floor/holofloor/grass,
/area/space)
"x" = (
/obj/effect/turf_decal/trimline/green/filled/line{
	dir = 8
	},
/obj/effect/turf_decal/trimline/green/filled/line{
	dir = 4
	},
/turf/open/floor/plasteel/dark,
/area/space)
"y" = (
/obj/structure/railing{
	dir = 10
	},
/turf/open/floor/holofloor/grass,
/area/space)
"z" = (
/obj/structure/flora/ausbushes/fullgrass,
/turf/open/floor/holofloor/grass,
/area/space)
"A" = (
/obj/effect/turf_decal/trimline/green/filled/line{
	dir = 1
	},
/obj/effect/turf_decal/trimline/green/filled/line,
/obj/effect/decal/cleanable/blood/tracks{
	dir = 4
	},
/turf/open/floor/plasteel/dark,
/area/space)
"B" = (
/obj/structure/railing{
	dir = 8
	},
/turf/open/floor/holofloor/grass,
/area/space)
"D" = (
/obj/effect/turf_decal/trimline/green/filled/line{
	dir = 9
	},
/obj/effect/turf_decal/trimline/green/filled/corner,
/turf/open/floor/plasteel/dark,
/area/space)
"E" = (
/obj/structure/flora/ausbushes,
/mob/living/simple_animal/chicken,
/turf/open/floor/holofloor/grass,
/area/space)
"F" = (
/obj/effect/turf_decal/trimline/green/filled/line{
	dir = 1
	},
/obj/effect/turf_decal/trimline/green/filled/line,
/obj/effect/decal/cleanable/blood/tracks{
	dir = 8
	},
/turf/open/floor/plasteel/dark,
/area/space)
"G" = (
/mob/living/simple_animal/chicken,
/turf/open/floor/holofloor/grass,
/area/space)
"H" = (
/obj/structure/railing,
/turf/open/floor/holofloor/grass,
/area/space)
"I" = (
/obj/effect/turf_decal/trimline/green/filled/corner{
	dir = 1
	},
/obj/effect/turf_decal/trimline/green/filled/corner,
/obj/effect/turf_decal/trimline/green/filled/corner{
	dir = 4
	},
/obj/effect/turf_decal/trimline/green/filled/corner{
	dir = 8
	},
/obj/effect/decal/cleanable/oil,
/obj/effect/decal/cleanable/robot_debris/general_scrap,
/obj/effect/decal/cleanable/blood/tracks{
	dir = 8
	},
/obj/machinery/light/floor,
/turf/open/floor/plasteel/dark,
/area/space)
"J" = (
/obj/structure/flora/ausbushes,
/obj/effect/decal/cleanable/blood/gibs/torso,
/obj/effect/decal/cleanable/blood/tracks,
/turf/open/floor/holofloor/grass,
/area/space)
"L" = (
/obj/structure/railing{
	dir = 1
	},
/turf/open/floor/holofloor/grass,
/area/space)
"M" = (
/obj/effect/turf_decal/trimline/green/filled/line{
	dir = 1
	},
/obj/effect/turf_decal/trimline/green/filled/corner{
	dir = 8
	},
/obj/effect/turf_decal/trimline/green/filled/corner,
/obj/machinery/light{
	dir = 1
	},
/turf/open/floor/plasteel/dark,
/area/space)
"N" = (
/obj/structure/flora/ausbushes/ywflowers,
/obj/structure/railing{
	dir = 1
	},
/turf/open/floor/holofloor/grass,
/area/space)
"O" = (
/obj/effect/turf_decal/trimline/green/filled/line{
	dir = 5
	},
/obj/effect/turf_decal/trimline/green/filled/corner{
	dir = 8
	},
/turf/open/floor/plasteel/dark,
/area/space)
"P" = (
/obj/effect/turf_decal/trimline/green/filled/line{
	dir = 1
	},
/obj/effect/turf_decal/trimline/green/filled/line,
/obj/effect/decal/cleanable/blood/gibs,
/turf/open/floor/plasteel/dark,
/area/space)
"Q" = (
/obj/effect/turf_decal/trimline/green/filled/corner{
	dir = 8
	},
/obj/effect/turf_decal/trimline/green/filled/corner,
/obj/effect/turf_decal/trimline/green/filled/corner{
	dir = 4
	},
/obj/effect/turf_decal/trimline/green/filled/corner{
	dir = 1
	},
/obj/effect/decal/cleanable/blood/tracks{
	dir = 10
	},
/obj/machinery/light/floor,
/turf/open/floor/plasteel/dark,
/area/space)
"R" = (
/obj/effect/turf_decal/trimline/green/filled/line{
	dir = 4
	},
/obj/effect/turf_decal/trimline/green/filled/line{
	dir = 8
	},
/obj/effect/decal/cleanable/blood/gibs/body,
/obj/effect/decal/cleanable/blood/tracks,
/turf/open/floor/plasteel/dark,
/area/space)
"U" = (
/obj/effect/turf_decal/trimline/green/filled/line{
	dir = 10
	},
/obj/effect/turf_decal/trimline/green/filled/corner{
	dir = 4
	},
/obj/effect/decal/cleanable/blood/splatter,
/turf/open/floor/plasteel/dark,
/area/space)
"V" = (
/obj/structure/railing{
	dir = 10
	},
/obj/effect/decal/cleanable/oil,
/obj/effect/decal/cleanable/robot_debris,
/turf/open/floor/holofloor/grass,
/area/space)
"W" = (
/obj/effect/turf_decal/trimline/green/filled/line{
	dir = 4
	},
/obj/effect/turf_decal/trimline/green/filled/line{
	dir = 8
	},
/obj/effect/decal/cleanable/blood/tracks,
/turf/open/floor/plasteel/dark,
/area/space)
"X" = (
/obj/effect/turf_decal/trimline/green/filled/line{
	dir = 6
	},
/obj/effect/turf_decal/trimline/green/filled/corner{
	dir = 1
	},
/turf/open/floor/plasteel/dark,
/area/space)
"Y" = (
/obj/structure/railing{
	dir = 5
	},
/turf/open/floor/holofloor/grass,
/area/space)
"Z" = (
/obj/effect/decal/cleanable/blood/gibs/up,
/obj/effect/decal/cleanable/blood/tracks{
	pixel_y = -11
	},
/turf/open/floor/holofloor/grass,
/area/space)

(1,1,1) = {"
a
D
x
x
x
g
x
x
x
U
a
"}
(2,1,1) = {"
a
v
m
b
V
h
i
B
y
h
a
"}
(3,1,1) = {"
a
A
N
E
m
h
m
z
m
h
a
"}
(4,1,1) = {"
a
A
m
m
w
h
Y
m
f
h
a
"}
(5,1,1) = {"
a
c
W
W
R
Q
j
j
j
s
a
"}
(6,1,1) = {"
a
h
t
m
m
F
t
m
i
h
a
"}
(7,1,1) = {"
a
h
L
r
m
F
z
p
G
l
a
"}
(8,1,1) = {"
a
h
i
m
m
F
m
e
n
h
a
"}
(9,1,1) = {"
a
M
j
j
j
I
j
j
j
d
a
"}
(10,1,1) = {"
a
h
m
z
y
k
o
m
u
h
a
"}
(11,1,1) = {"
a
h
m
i
H
h
L
Z
J
h
a
"}
(12,1,1) = {"
a
P
Y
m
m
h
r
m
f
h
a
"}
(13,1,1) = {"
a
O
j
j
j
q
j
j
j
X
a
"}
