//MAP CONVERTED BY dmm2tgm.py THIS HEADER COMMENT PREVENTS RECONVERSION, DO NOT REMOVE
"a" = (
/turf/closed/indestructible/reinforced,
/area/city/backstreets_room)
"e" = (
/obj/structure/window/reinforced{
	dir = 4;
	pixel_x = 8
	},
/turf/open/floor/plating/asteroid/basalt,
/area/city/backstreets_room)
"h" = (
/obj/item/folder/documents,
/obj/effect/spawner/structure/window/plasma/reinforced/plastitanium,
/turf/open/floor/plating/asteroid/basalt,
/area/city/backstreets_room)
"j" = (
/obj/effect/light_emitter{
	light_power = 4;
	light_range = 25;
	set_cap = 3;
	set_luminosity = 24
	},
/turf/open/floor/plating/asteroid/basalt,
/area/city/backstreets_room)
"m" = (
/obj/structure/sign/poster/contraband/busty_backdoor_xeno_babes_6,
/turf/closed/indestructible/reinforced,
/area/city/backstreets_room)
"o" = (
/turf/open/space/basic,
/area/city/backstreets_room)
"p" = (
/obj/structure/sign/poster/official/cohiba_robusto_ad,
/turf/closed/indestructible/reinforced,
/area/city/backstreets_room)
"D" = (
/obj/structure/window/reinforced{
	dir = 1;
	pixel_y = 8
	},
/turf/open/floor/plating/asteroid/basalt,
/area/city/backstreets_room)
"F" = (
/obj/structure/sign/poster/contraband/robust_softdrinks,
/turf/closed/indestructible/reinforced,
/area/city/backstreets_room)
"Q" = (
/turf/open/floor/plating/asteroid/basalt,
/area/city/backstreets_room)
"R" = (
/obj/structure/window/reinforced{
	dir = 8;
	pixel_x = -8
	},
/turf/open/floor/plating/asteroid/basalt,
/area/city/backstreets_room)
"S" = (
/obj/structure/window/reinforced{
	pixel_y = -8
	},
/turf/open/floor/plating/asteroid/basalt,
/area/city/backstreets_room)
"W" = (
/obj/effect/spawner/lootdrop/cigbutt,
/turf/open/floor/plating/asteroid/basalt,
/area/city/backstreets_room)

(1,1,1) = {"
a
a
a
a
a
a
Q
Q
Q
a
a
a
a
a
a
"}
(2,1,1) = {"
a
o
o
o
o
o
a
Q
a
a
a
a
a
a
a
"}
(3,1,1) = {"
a
o
a
o
o
a
F
W
a
a
a
a
a
a
a
"}
(4,1,1) = {"
a
o
o
o
o
o
a
Q
a
a
a
a
a
a
a
"}
(5,1,1) = {"
a
a
o
o
a
a
a
Q
a
a
a
a
a
a
a
"}
(6,1,1) = {"
Q
a
a
a
a
a
j
e
j
a
a
a
a
a
Q
"}
(7,1,1) = {"
Q
Q
Q
W
Q
Q
S
h
D
Q
W
Q
Q
Q
Q
"}
(8,1,1) = {"
Q
a
a
a
p
a
j
R
j
a
a
a
a
a
Q
"}
(9,1,1) = {"
a
a
a
a
a
a
a
Q
a
a
a
a
a
a
a
"}
(10,1,1) = {"
a
a
a
a
a
a
a
W
m
a
a
a
a
a
a
"}
(11,1,1) = {"
a
a
a
a
a
a
a
W
a
a
a
a
a
a
a
"}
(12,1,1) = {"
a
a
a
a
a
a
a
Q
a
a
a
a
a
a
a
"}
(13,1,1) = {"
a
a
a
a
a
a
Q
Q
Q
a
a
a
a
a
a
"}
