//MAP CONVERTED BY dmm2tgm.py THIS HEADER COMMENT PREVENTS RECONVERSION, DO NOT REMOVE
"a" = (
/turf/closed/indestructible/reinforced,
/area/city/backstreets_room)
"c" = (
/obj/structure/railing{
	dir = 10;
	name = "invincible railing";
	max_integrity = 1e+007
	},
/mob/living/simple_animal/hostile/ordeal/green_bot_big{
	name = "gun bot"
	},
/obj/effect/light_emitter{
	light_power = 4;
	light_range = 25;
	set_cap = 3;
	set_luminosity = 24
	},
/turf/open/floor/mineral/plastitanium/red,
/area/city/backstreets_room)
"d" = (
/obj/structure/railing{
	dir = 8
	},
/obj/effect/turf_decal/delivery/white,
/turf/open/floor/mineral/plastitanium,
/area/city/backstreets_room)
"e" = (
/obj/structure/railing{
	dir = 6
	},
/turf/open/floor/mineral/plastitanium/red,
/area/city/backstreets_room)
"f" = (
/obj/structure/flora/ausbushes/sparsegrass,
/turf/open/floor/plating/ashplanet/wateryrock,
/area/city/backstreets_room)
"g" = (
/obj/effect/decal/cleanable/blood/tracks{
	dir = 10
	},
/turf/open/floor/plating/asteroid/basalt,
/area/city/backstreets_room)
"h" = (
/obj/structure/railing{
	dir = 9;
	name = "invincible railing";
	max_integrity = 1e+007
	},
/mob/living/simple_animal/hostile/ordeal/green_bot_big{
	name = "gun bot"
	},
/obj/effect/light_emitter{
	light_power = 4;
	light_range = 25;
	set_cap = 3;
	set_luminosity = 24
	},
/turf/open/floor/mineral/plastitanium/red,
/area/city/backstreets_room)
"i" = (
/obj/structure/railing,
/obj/effect/turf_decal/caution/stand_clear/red{
	dir = 1
	},
/turf/open/floor/mineral/plastitanium,
/area/city/backstreets_room)
"j" = (
/obj/structure/railing{
	dir = 5
	},
/obj/item/raw_anomaly_core/flux,
/turf/open/floor/mineral/plastitanium/red,
/area/city/backstreets_room)
"k" = (
/obj/structure/railing{
	dir = 10
	},
/obj/effect/light_emitter{
	light_power = 4;
	light_range = 25;
	set_cap = 3;
	set_luminosity = 24
	},
/turf/open/floor/mineral/plastitanium,
/area/city/backstreets_room)
"l" = (
/obj/effect/decal/cleanable/blood/tracks{
	dir = 8
	},
/turf/open/floor/plating/asteroid/basalt,
/area/city/backstreets_room)
"o" = (
/obj/structure/railing{
	dir = 10
	},
/obj/item/stack/spacecash/c200,
/turf/open/floor/mineral/plastitanium/red,
/area/city/backstreets_room)
"p" = (
/obj/structure/railing{
	dir = 1
	},
/obj/item/stack/spacecash/c200,
/turf/open/floor/mineral/plastitanium/red,
/area/city/backstreets_room)
"q" = (
/obj/effect/decal/cleanable/blood/tracks{
	dir = 5
	},
/turf/open/floor/plating/asteroid/basalt,
/area/city/backstreets_room)
"r" = (
/obj/structure/railing{
	dir = 8;
	name = "invincible railing";
	max_integrity = 1e+007
	},
/obj/structure/railing{
	dir = 1;
	name = "invincible railing";
	max_integrity = 1e+007
	},
/obj/structure/railing{
	dir = 4;
	name = "invincible railing";
	max_integrity = 1e+007
	},
/obj/structure/railing{
	name = "invincible railing";
	max_integrity = 1e+007
	},
/mob/living/simple_animal/hostile/ordeal/green_bot_big{
	name = "gun bot"
	},
/turf/open/floor/mineral/plastitanium/red,
/area/city/backstreets_room)
"s" = (
/obj/structure/railing{
	dir = 1
	},
/obj/effect/turf_decal/caution/stand_clear/red,
/turf/open/floor/mineral/plastitanium,
/area/city/backstreets_room)
"u" = (
/obj/structure/railing{
	dir = 4
	},
/obj/effect/turf_decal/delivery/white,
/turf/open/floor/mineral/plastitanium,
/area/city/backstreets_room)
"v" = (
/obj/structure/railing{
	dir = 10
	},
/turf/open/floor/mineral/plastitanium,
/area/city/backstreets_room)
"w" = (
/obj/structure/flora/ausbushes/lavendergrass,
/obj/structure/flora/ausbushes/sparsegrass,
/turf/open/floor/plating/ashplanet/wateryrock,
/area/city/backstreets_room)
"y" = (
/obj/structure/railing{
	dir = 5
	},
/obj/effect/light_emitter{
	light_power = 4;
	light_range = 25;
	set_cap = 3;
	set_luminosity = 24
	},
/turf/open/floor/plating,
/area/city/backstreets_room)
"z" = (
/obj/structure/flora/rock/jungle,
/turf/open/floor/plating/ashplanet/wateryrock,
/area/city/backstreets_room)
"A" = (
/obj/structure/railing,
/turf/open/floor/mineral/plastitanium/red,
/area/city/backstreets_room)
"B" = (
/obj/structure/railing{
	dir = 5
	},
/turf/open/floor/mineral/plastitanium,
/area/city/backstreets_room)
"C" = (
/obj/structure/railing,
/obj/effect/turf_decal/delivery/white,
/turf/open/floor/mineral/plastitanium,
/area/city/backstreets_room)
"D" = (
/obj/structure/railing{
	dir = 9
	},
/turf/open/floor/mineral/plastitanium/red,
/area/city/backstreets_room)
"E" = (
/obj/effect/decal/cleanable/blood/tracks,
/turf/open/floor/plating/asteroid/basalt,
/area/city/backstreets_room)
"F" = (
/obj/structure/railing{
	dir = 4
	},
/obj/effect/turf_decal/caution/stand_clear/red{
	dir = 8
	},
/turf/open/floor/mineral/plastitanium,
/area/city/backstreets_room)
"G" = (
/obj/structure/flora/rock,
/turf/open/floor/plating/asteroid/basalt,
/area/city/backstreets_room)
"H" = (
/obj/structure/railing{
	dir = 5;
	name = "invincible railing";
	max_integrity = 1e+007
	},
/mob/living/simple_animal/hostile/ordeal/green_bot_big{
	name = "gun bot"
	},
/obj/effect/light_emitter{
	light_power = 4;
	light_range = 25;
	set_cap = 3;
	set_luminosity = 24
	},
/turf/open/floor/mineral/plastitanium/red,
/area/city/backstreets_room)
"I" = (
/obj/structure/railing{
	dir = 6
	},
/obj/effect/light_emitter{
	light_power = 4;
	light_range = 25;
	set_cap = 3;
	set_luminosity = 24
	},
/turf/open/floor/mineral/plastitanium,
/area/city/backstreets_room)
"J" = (
/obj/item/aquarium_prop/rocks,
/turf/open/floor/plating/asteroid/basalt,
/area/city/backstreets_room)
"L" = (
/obj/structure/railing{
	dir = 9
	},
/obj/effect/light_emitter{
	light_power = 4;
	light_range = 25;
	set_cap = 3;
	set_luminosity = 24
	},
/turf/open/floor/mineral/plastitanium,
/area/city/backstreets_room)
"M" = (
/obj/structure/flora/ausbushes/lavendergrass,
/turf/open/floor/plating/ashplanet/wateryrock,
/area/city/backstreets_room)
"N" = (
/obj/structure/railing{
	dir = 6
	},
/turf/open/floor/mineral/plastitanium,
/area/city/backstreets_room)
"O" = (
/obj/structure/railing{
	dir = 8
	},
/obj/item/raw_anomaly_core/pyro,
/turf/open/floor/mineral/plastitanium/red,
/area/city/backstreets_room)
"Q" = (
/turf/open/floor/plating/asteroid/basalt,
/area/city/backstreets_room)
"R" = (
/obj/structure/railing{
	dir = 9
	},
/turf/open/floor/mineral/plastitanium,
/area/city/backstreets_room)
"S" = (
/obj/structure/railing{
	dir = 1
	},
/obj/effect/turf_decal/delivery/white,
/turf/open/floor/mineral/plastitanium,
/area/city/backstreets_room)
"W" = (
/obj/structure/railing{
	dir = 4
	},
/turf/open/floor/mineral/plastitanium/red,
/area/city/backstreets_room)
"X" = (
/obj/structure/railing{
	dir = 8
	},
/obj/effect/turf_decal/caution/stand_clear/red{
	dir = 4
	},
/turf/open/floor/mineral/plastitanium,
/area/city/backstreets_room)
"Y" = (
/obj/structure/flora/rock/pile,
/obj/effect/decal/cleanable/blood/tracks{
	dir = 8
	},
/turf/open/floor/plating/asteroid/basalt,
/area/city/backstreets_room)
"Z" = (
/obj/structure/railing{
	dir = 6;
	name = "invincible railing";
	max_integrity = 1e+007
	},
/mob/living/simple_animal/hostile/ordeal/green_bot_big{
	name = "gun bot"
	},
/obj/effect/light_emitter{
	light_power = 4;
	light_range = 25;
	set_cap = 3;
	set_luminosity = 24
	},
/turf/open/floor/mineral/plastitanium/red,
/area/city/backstreets_room)

(1,1,1) = {"
a
a
a
a
a
a
Q
f
l
a
a
a
a
a
a
"}
(2,1,1) = {"
a
a
a
a
a
a
Q
Q
l
a
a
a
a
a
a
"}
(3,1,1) = {"
a
a
Z
C
Q
Q
G
Q
l
Q
Q
S
H
a
a
"}
(4,1,1) = {"
a
a
u
N
J
Q
Q
Q
q
E
g
B
u
a
a
"}
(5,1,1) = {"
a
a
Q
Q
Q
L
d
X
d
k
Y
w
M
a
a
"}
(6,1,1) = {"
Q
Q
M
Q
Q
S
D
O
o
C
l
Q
w
Q
Q
"}
(7,1,1) = {"
Q
Q
Q
w
Q
s
p
r
A
i
l
Q
Q
Q
Q
"}
(8,1,1) = {"
Q
Q
Q
Q
Q
S
j
W
e
C
l
M
Q
Q
Q
"}
(9,1,1) = {"
a
a
Q
Q
Q
y
u
F
u
I
l
Q
Q
a
a
"}
(10,1,1) = {"
a
a
d
v
Q
Q
Q
Q
Q
Q
q
R
d
a
a
"}
(11,1,1) = {"
a
a
c
C
z
Q
w
Q
Q
Q
Q
S
h
a
a
"}
(12,1,1) = {"
a
a
a
a
a
a
Q
Q
w
a
a
a
a
a
a
"}
(13,1,1) = {"
a
a
a
a
a
a
Q
Q
Q
a
a
a
a
a
a
"}
