//MAP CONVERTED BY dmm2tgm.py THIS HEADER COMMENT PREVENTS RECONVERSION, DO NOT REMOVE
"a" = (
/turf/closed/indestructible/reinforced,
/area/city/backstreets_room)
"b" = (
/turf/closed/indestructible/fakedoor{
	name = "Bolted Door"
	},
/area/city/backstreets_room)
"c" = (
/obj/effect/decal/cleanable/blood/drip,
/obj/effect/decal/cleanable/blood/tracks{
	dir = 4
	},
/turf/open/floor/plating/dirt/jungle/dark,
/area/city/backstreets_room)
"d" = (
/obj/structure/barricade/wooden,
/obj/structure/barricade/wooden,
/obj/structure/barricade/wooden/crude,
/turf/closed/indestructible/fakeglass,
/area/city/backstreets_room)
"f" = (
/obj/effect/decal/cleanable/blood/footprints{
	dir = 8
	},
/turf/open/floor/plating/dirt/jungle/dark,
/area/city/backstreets_room)
"g" = (
/obj/effect/decal/cleanable/blood/tracks{
	dir = 4
	},
/turf/open/floor/plating/dirt/jungle/dark,
/area/city/backstreets_room)
"i" = (
/obj/effect/decal/cleanable/blood/tracks{
	dir = 8
	},
/obj/item/gun/ego_gun/clerk,
/turf/open/floor/plating/dirt/jungle/dark,
/area/city/backstreets_room)
"n" = (
/obj/effect/decal/cleanable/blood{
	pixel_x = 11
	},
/turf/open/floor/plating/dirt/jungle/dark,
/area/city/backstreets_room)
"o" = (
/obj/effect/decal/cleanable/blood/tracks,
/turf/open/floor/plating/dirt/jungle/dark,
/area/city/backstreets_room)
"q" = (
/obj/effect/decal/cleanable/blood/tracks{
	dir = 5
	},
/obj/effect/decal/cleanable/blood{
	pixel_x = -3;
	pixel_y = -8
	},
/turf/open/floor/plating/dirt/jungle/dark,
/area/city/backstreets_room)
"r" = (
/obj/effect/decal/cleanable/blood/gibs/limb,
/turf/open/floor/plating/dirt/jungle/dark,
/area/city/backstreets_room)
"t" = (
/obj/effect/decal/cleanable/blood/gibs,
/turf/open/floor/plating/dirt/jungle/dark,
/area/city/backstreets_room)
"u" = (
/obj/effect/decal/cleanable/blood/splatter,
/obj/effect/spawner/randomcolavend,
/turf/open/floor/plating/dirt/jungle/dark,
/area/city/backstreets_room)
"v" = (
/obj/effect/decal/cleanable/blood/gibs/limb{
	dir = 1
	},
/turf/open/floor/plating/dirt/jungle/dark,
/area/city/backstreets_room)
"x" = (
/obj/effect/decal/cleanable/blood/footprints{
	dir = 3
	},
/turf/open/floor/plating/dirt/jungle/dark,
/area/city/backstreets_room)
"A" = (
/obj/effect/decal/cleanable/blood/gibs/up,
/turf/open/floor/plating/dirt/jungle/dark,
/area/city/backstreets_room)
"B" = (
/obj/effect/decal/cleanable/blood/gibs/down,
/turf/open/floor/plating/dirt/jungle/dark,
/area/city/backstreets_room)
"C" = (
/obj/effect/decal/cleanable/blood/gibs/torso,
/turf/open/floor/plating/dirt/jungle/dark,
/area/city/backstreets_room)
"D" = (
/obj/effect/decal/cleanable/blood/drip,
/turf/open/floor/plating/dirt/jungle/dark,
/area/city/backstreets_room)
"F" = (
/obj/structure/stone_tile/slab/cracked,
/mob/living/simple_animal/hostile/ordeal/indigo_noon,
/turf/open/floor/plating/dirt/jungle/wasteland,
/area/city/backstreets_room)
"G" = (
/obj/effect/decal/cleanable/blood{
	pixel_x = -3;
	pixel_y = -8
	},
/turf/open/floor/plating/dirt/jungle/dark,
/area/city/backstreets_room)
"H" = (
/mob/living/simple_animal/hostile/ordeal/indigo_noon,
/turf/open/floor/plating/dirt/jungle/dark,
/area/city/backstreets_room)
"I" = (
/obj/structure/stone_tile/slab/cracked,
/turf/open/floor/plating/dirt/jungle/wasteland,
/area/city/backstreets_room)
"L" = (
/obj/effect/decal/cleanable/blood/footprints{
	dir = 3
	},
/obj/effect/decal/cleanable/blood{
	pixel_x = -3;
	pixel_y = -8
	},
/turf/open/floor/plating/dirt/jungle/dark,
/area/city/backstreets_room)
"M" = (
/obj/effect/decal/cleanable/blood{
	pixel_x = -5;
	pixel_y = 17
	},
/turf/open/floor/plating/dirt/jungle/dark,
/area/city/backstreets_room)
"O" = (
/obj/effect/decal/cleanable/blood/gibs/old,
/obj/machinery/vending/cigarette,
/turf/open/floor/plating/dirt/jungle/dark,
/area/city/backstreets_room)
"Q" = (
/obj/structure/barricade/wooden,
/obj/structure/barricade/wooden/crude,
/turf/closed/indestructible/fakeglass,
/area/city/backstreets_room)
"R" = (
/obj/structure/stone_tile/slab/cracked,
/obj/item/bodypart/l_arm{
	dir = 4;
	pixel_x = -12;
	pixel_y = -7
	},
/obj/item/ego_weapon/city/rats/knife,
/turf/open/floor/plating/dirt/jungle/wasteland,
/area/city/backstreets_room)
"S" = (
/turf/open/floor/plating/dirt/jungle/dark,
/area/city/backstreets_room)
"T" = (
/obj/structure/stone_tile/slab/cracked,
/obj/effect/light_emitter{
	light_power = 4;
	light_range = 25;
	set_cap = 3;
	set_luminosity = 24
	},
/turf/open/floor/plating/dirt/jungle/wasteland,
/area/city/backstreets_room)
"U" = (
/turf/closed/indestructible/rock,
/area/city/backstreets_room)
"V" = (
/obj/effect/decal/cleanable/blood/splatter,
/turf/open/floor/plating/dirt/jungle/dark,
/area/city/backstreets_room)
"W" = (
/obj/effect/decal/cleanable/blood{
	pixel_x = -3;
	pixel_y = -8
	},
/obj/effect/decal/cleanable/blood{
	pixel_x = -5;
	pixel_y = 17
	},
/turf/open/floor/plating/dirt/jungle/dark,
/area/city/backstreets_room)
"X" = (
/mob/living/simple_animal/hostile/ordeal/indigo_spawn,
/turf/open/floor/plating/dirt/jungle/dark,
/area/city/backstreets_room)
"Y" = (
/obj/effect/decal/cleanable/blood,
/turf/open/floor/plating/dirt/jungle/dark,
/area/city/backstreets_room)
"Z" = (
/obj/effect/decal/cleanable/blood/gibs/old,
/turf/open/floor/plating/dirt/jungle/dark,
/area/city/backstreets_room)

(1,1,1) = {"
U
U
U
U
U
a
I
I
S
a
U
U
U
U
U
"}
(2,1,1) = {"
U
a
Q
Q
b
a
S
S
S
a
b
Q
Q
a
U
"}
(3,1,1) = {"
a
a
S
S
q
B
S
x
H
S
L
X
V
a
a
"}
(4,1,1) = {"
b
W
o
C
I
S
g
v
S
D
I
S
S
S
b
"}
(5,1,1) = {"
Q
V
S
I
I
S
Z
S
S
S
R
I
t
S
Q
"}
(6,1,1) = {"
Q
S
S
X
x
S
D
B
o
A
S
I
S
S
Q
"}
(7,1,1) = {"
a
O
S
g
S
S
V
T
f
S
S
I
S
u
a
"}
(8,1,1) = {"
Q
A
o
S
S
t
S
S
S
S
Y
S
S
S
Q
"}
(9,1,1) = {"
Q
S
I
F
S
S
Z
S
Y
S
X
S
c
A
Q
"}
(10,1,1) = {"
b
M
r
I
I
S
I
S
B
o
o
C
o
G
b
"}
(11,1,1) = {"
a
a
Z
S
i
Y
H
S
V
D
n
S
S
a
a
"}
(12,1,1) = {"
U
a
Q
d
b
a
S
x
I
a
b
Q
Q
a
U
"}
(13,1,1) = {"
U
U
U
U
U
a
S
I
S
a
U
U
U
U
U
"}
