//MAP CONVERTED BY dmm2tgm.py THIS HEADER COMMENT PREVENTS RECONVERSION, DO NOT REMOVE
"a" = (
/turf/closed/indestructible/reinforced,
/area/city/backstreets_room)
"N" = (
/obj/item/stack/spacecash/c100,
/turf/open/floor/plating/asteroid/basalt,
/area/city/backstreets_room)
"Q" = (
/turf/open/floor/plating/asteroid/basalt,
/area/city/backstreets_room)
"S" = (
/turf/closed/indestructible/fakeglass,
/area/city/backstreets_room)
"W" = (
/turf/open/chasm,
/area/city/backstreets_room)

(1,1,1) = {"
a
a
a
a
a
a
Q
Q
Q
Q
a
a
a
a
a
"}
(2,1,1) = {"
a
W
W
W
W
S
Q
Q
Q
Q
S
W
W
W
a
"}
(3,1,1) = {"
a
W
W
W
W
S
S
Q
N
Q
S
W
W
W
a
"}
(4,1,1) = {"
a
W
W
W
W
W
S
Q
Q
Q
S
W
W
W
a
"}
(5,1,1) = {"
a
S
S
S
S
W
S
Q
Q
S
S
S
S
S
a
"}
(6,1,1) = {"
Q
Q
Q
Q
S
S
S
Q
Q
S
Q
Q
Q
Q
Q
"}
(7,1,1) = {"
Q
Q
Q
N
Q
Q
S
S
S
S
Q
Q
N
Q
Q
"}
(8,1,1) = {"
Q
Q
S
S
S
S
W
S
Q
S
Q
Q
Q
Q
Q
"}
(9,1,1) = {"
a
S
S
W
W
S
S
S
Q
S
S
S
Q
Q
Q
"}
(10,1,1) = {"
a
W
W
W
W
S
Q
Q
Q
S
W
S
S
S
a
"}
(11,1,1) = {"
a
W
W
W
W
S
Q
N
Q
S
W
W
W
W
a
"}
(12,1,1) = {"
a
W
W
W
W
S
Q
Q
Q
S
W
W
W
W
a
"}
(13,1,1) = {"
a
a
a
a
a
a
Q
Q
Q
a
a
a
a
a
a
"}
