//MAP CONVERTED BY dmm2tgm.py THIS HEADER COMMENT PREVENTS RECONVERSION, DO NOT REMOVE
"a" = (
/turf/open/space/basic,
/area/space)
"b" = (
/obj/structure/table/wood/poker,
/turf/open/space/basic,
/turf/open/floor/holofloor/dark,
/area/space)
"c" = (
/obj/machinery/cryopod,
/turf/open/floor/holofloor/dark,
/area/space)
"d" = (
/obj/effect/turf_decal/caution/stand_clear,
/obj/machinery/door/window/brigdoor/southright{
	dir = 1
	},
/obj/machinery/door/poddoor/preopen{
	id = "managerlockdown";
	name = "Manager's Office Lockdown Blast Door"
	},
/obj/effect/turf_decal/stripes/line{
	dir = 1
	},
/turf/open/floor/plasteel,
/area/space)
"e" = (
/obj/structure/sign/warning/securearea,
/turf/open/space/basic,
/turf/open/floor/holofloor/dark,
/area/space)
"f" = (
/obj/structure/bed,
/obj/item/bedsheet/captain,
/turf/open/floor/holofloor/dark,
/area/space)
"g" = (
/obj/machinery/light,
/turf/open/space/basic,
/turf/open/floor/holofloor/dark,
/area/space)
"h" = (
/obj/structure/table/wood,
/turf/open/space/basic,
/turf/open/floor/holofloor/dark,
/area/space)
"i" = (
/obj/effect/spawner/structure/window/plasma/reinforced,
/obj/structure/grille/indestructable,
/turf/open/floor/plating/airless,
/turf/open/floor/plating/airless,
/area/space)
"k" = (
/obj/structure/bed,
/obj/item/bedsheet/ian,
/turf/open/floor/holofloor/dark,
/area/space)
"l" = (
/turf/closed/indestructible/reinforced,
/area/space)
"m" = (
/obj/structure/chair/stool/bar,
/turf/open/space/basic,
/turf/open/floor/holofloor/dark,
/area/space)
"o" = (
/obj/item/target/clown,
/turf/open/floor/holofloor/dark,
/area/space)
"p" = (
/obj/structure/table/wood,
/obj/item/reagent_containers/food/drinks/shaker{
	pixel_x = -9
	},
/obj/item/reagent_containers/food/drinks/bottle/absinthe/premium{
	pixel_x = 5
	},
/turf/open/space/basic,
/turf/open/floor/holofloor/dark,
/area/space)
"q" = (
/turf/closed/indestructible/reinforced,
/turf/open/floor/plating/airless,
/area/space)
"r" = (
/turf/open/floor/holofloor/dark,
/turf/closed/indestructible/reinforced,
/area/space)
"s" = (
/obj/machinery/vending/boozeomat/all_access,
/turf/open/space/basic,
/turf/open/floor/holofloor/dark,
/area/space)
"t" = (
/obj/structure/table/wood/poker,
/obj/item/reagent_containers/food/drinks/beer{
	pixel_x = -8
	},
/turf/open/space/basic,
/turf/open/floor/holofloor/dark,
/area/space)
"u" = (
/obj/structure/chair/comfy/beige{
	dir = 8
	},
/turf/open/space/basic,
/turf/open/floor/holofloor/dark,
/area/space)
"v" = (
/obj/item/toy/plush/netzach,
/obj/item/reagent_containers/food/drinks/beer{
	pixel_x = 11
	},
/obj/item/wrench{
	pixel_x = -13
	},
/turf/closed/indestructible/rock,
/area/space)
"w" = (
/turf/open/space/basic,
/turf/open/floor/plasteel/elevatorshaft,
/area/space)
"y" = (
/obj/structure/chair/comfy/beige{
	dir = 1
	},
/turf/open/space/basic,
/turf/open/floor/holofloor/dark,
/area/space)
"z" = (
/obj/machinery/computer/slot_machine,
/turf/open/space/basic,
/turf/open/floor/holofloor/dark,
/area/space)
"A" = (
/obj/structure/bed,
/obj/item/bedsheet/k_corporation,
/turf/open/floor/holofloor/dark,
/area/space)
"B" = (
/obj/machinery/light,
/obj/structure/cursed_slot_machine,
/turf/open/space/basic,
/turf/open/floor/holofloor/dark,
/area/space)
"C" = (
/obj/machinery/chem_dispenser/drinks/beer/fullupgrade,
/obj/structure/table/wood,
/turf/open/space/basic,
/turf/open/floor/holofloor/dark,
/area/space)
"E" = (
/obj/machinery/door/airlock/wood/glass,
/turf/open/floor/holofloor/dark,
/area/space)
"F" = (
/turf/open/floor/holofloor/dark,
/area/space)
"G" = (
/obj/machinery/light{
	dir = 1
	},
/obj/machinery/regenerator,
/turf/open/space/basic,
/turf/open/floor/holofloor/dark,
/area/space)
"H" = (
/obj/structure/chair/comfy/black,
/turf/open/floor/holofloor/dark,
/area/space)
"J" = (
/obj/structure/railing{
	dir = 1
	},
/obj/machinery/computer/shuttle/mining{
	dir = 4;
	name = "elevator console";
	possible_destinations = "elevator_home;elevator_away";
	shuttleId = "manager"
	},
/obj/machinery/door/poddoor/preopen{
	id = "managerlockdown";
	name = "Manager's Office Lockdown Blast Door"
	},
/obj/effect/turf_decal/stripes/line{
	dir = 1
	},
/turf/open/floor/plasteel/dark,
/area/space)
"K" = (
/turf/open/floor/engine,
/turf/closed/indestructible/reinforced,
/area/space)
"L" = (
/obj/machinery/computer/camera_advanced/manager/sephirah{
	dir = 1
	},
/turf/open/floor/holofloor/dark,
/area/space)
"M" = (
/obj/machinery/door/airlock/wood/glass,
/turf/open/space/basic,
/turf/open/floor/plating/airless,
/turf/open/floor/circuit/telecomms/mainframe,
/turf/open/floor/holofloor/dark,
/area/space)
"N" = (
/obj/structure/sign/ordealmonitor,
/turf/closed/indestructible/reinforced,
/turf/open/floor/plating/airless,
/area/space)
"O" = (
/obj/structure/chair/comfy/beige,
/turf/open/space/basic,
/turf/open/floor/holofloor/dark,
/area/space)
"P" = (
/turf/closed/indestructible/reinforced,
/turf/closed/indestructible/reinforced,
/area/space)
"Q" = (
/obj/machinery/chem_dispenser/drinks/fullupgrade,
/obj/structure/table/wood,
/turf/open/space/basic,
/turf/open/floor/holofloor/dark,
/area/space)
"R" = (
/obj/machinery/light{
	dir = 1
	},
/turf/open/space/basic,
/turf/open/floor/holofloor/dark,
/area/space)
"S" = (
/obj/structure/bed,
/obj/item/bedsheet/cosmos,
/turf/open/floor/holofloor/dark,
/area/space)
"T" = (
/turf/closed/indestructible/rock,
/area/space)
"U" = (
/turf/open/space/basic,
/turf/open/floor/holofloor/dark,
/area/space)
"V" = (
/obj/structure/railing{
	dir = 1
	},
/obj/machinery/door/poddoor/preopen{
	id = "managerlockdown";
	name = "Manager's Office Lockdown Blast Door"
	},
/obj/effect/turf_decal/stripes/line{
	dir = 1
	},
/turf/open/floor/plasteel/dark,
/area/space)
"X" = (
/obj/structure/table/reinforced,
/obj/structure/railing{
	dir = 1
	},
/turf/open/floor/holofloor/dark,
/area/space)
"Y" = (
/obj/structure/chair/comfy/beige{
	dir = 4
	},
/turf/open/space/basic,
/turf/open/floor/holofloor/dark,
/area/space)
"Z" = (
/obj/structure/table/wood/poker,
/obj/item/toy/cards/deck/syndicate{
	pixel_y = 5
	},
/turf/open/space/basic,
/turf/open/floor/holofloor/dark,
/area/space)

(1,1,1) = {"
a
a
a
a
a
a
a
a
a
a
a
a
a
a
a
a
a
a
a
a
a
a
a
a
a
a
a
a
a
a
a
a
a
a
a
a
a
a
a
a
a
a
a
a
a
a
a
a
a
a
"}
(2,1,1) = {"
a
a
a
a
a
a
a
a
a
a
a
a
a
a
a
a
a
a
a
a
a
a
a
a
a
a
a
a
a
a
a
a
a
a
a
a
a
a
a
a
a
a
a
a
a
a
a
a
a
a
"}
(3,1,1) = {"
a
a
a
a
a
a
a
a
a
a
a
a
a
a
a
a
a
a
a
a
a
a
a
a
a
a
a
a
a
a
a
a
a
a
a
a
a
a
a
a
a
a
a
a
a
a
a
a
a
a
"}
(4,1,1) = {"
a
a
a
a
a
a
a
a
a
a
a
a
a
a
a
a
a
a
a
a
a
a
a
a
a
a
a
a
a
a
a
a
a
a
a
a
a
a
a
a
a
a
a
a
a
a
a
a
a
a
"}
(5,1,1) = {"
a
a
a
a
a
a
a
a
a
a
a
a
a
a
a
a
a
a
a
a
a
a
a
a
a
a
a
a
a
a
a
a
a
a
a
a
a
a
a
a
a
a
a
a
a
a
a
a
a
a
"}
(6,1,1) = {"
a
a
a
a
a
a
a
a
a
a
a
a
a
a
a
a
a
a
a
a
a
a
a
a
a
a
a
a
a
a
a
a
a
a
a
a
a
a
a
a
a
a
a
a
a
a
a
a
a
a
"}
(7,1,1) = {"
a
a
a
a
a
a
a
a
a
a
a
a
a
a
a
a
a
a
a
a
a
a
a
a
a
a
a
a
a
a
a
a
a
a
a
a
a
a
a
a
a
a
a
a
a
a
a
a
a
a
"}
(8,1,1) = {"
a
a
a
a
a
a
a
a
a
a
a
a
a
a
a
a
a
a
a
a
a
a
a
a
a
a
a
a
a
a
a
a
a
a
a
a
a
a
a
a
a
a
a
a
a
a
a
a
a
a
"}
(9,1,1) = {"
a
a
a
a
a
a
a
a
a
a
a
a
a
a
a
a
a
a
a
a
a
a
a
a
a
a
a
a
a
a
a
a
a
a
a
a
a
a
a
a
a
a
a
a
a
a
a
a
a
a
"}
(10,1,1) = {"
a
a
a
a
a
a
a
a
a
a
a
a
a
a
a
a
a
a
a
a
a
a
a
a
a
a
a
a
a
a
a
a
a
a
a
a
a
a
a
a
a
a
a
a
a
a
a
a
a
a
"}
(11,1,1) = {"
a
a
a
a
a
a
a
a
a
a
a
a
a
a
a
a
a
a
a
a
a
a
a
a
a
a
a
a
a
a
a
a
a
a
a
a
a
a
a
a
a
a
a
a
a
a
a
a
a
a
"}
(12,1,1) = {"
a
a
a
a
a
a
a
a
a
a
a
a
a
a
a
a
a
a
a
a
a
a
a
a
a
a
a
a
a
a
a
a
a
a
a
a
a
a
a
a
a
a
a
a
a
a
a
a
a
a
"}
(13,1,1) = {"
a
a
a
a
a
a
a
a
a
a
a
a
a
a
a
a
a
a
a
a
a
a
a
a
a
a
a
a
a
a
a
a
a
a
a
a
a
a
a
a
a
a
a
a
a
a
a
a
a
a
"}
(14,1,1) = {"
a
a
a
a
a
a
a
a
a
a
a
T
T
T
T
T
T
T
T
T
T
T
T
T
q
q
q
q
q
q
q
l
l
l
l
l
l
a
a
a
a
a
a
a
a
a
a
a
a
a
"}
(15,1,1) = {"
a
a
a
a
a
a
a
a
a
a
a
T
T
T
T
T
T
T
T
T
T
T
T
T
K
A
F
F
F
c
q
F
F
X
F
o
l
a
a
a
a
a
a
a
a
a
a
a
a
a
"}
(16,1,1) = {"
a
a
a
a
a
a
a
a
a
a
a
T
T
T
T
T
T
T
T
T
T
T
T
T
q
q
q
F
q
q
N
F
l
P
l
l
l
a
a
a
a
a
a
a
a
a
a
a
a
a
"}
(17,1,1) = {"
a
a
a
a
a
a
a
a
a
a
a
T
T
T
T
T
T
v
T
T
T
T
T
T
q
k
F
F
F
F
E
F
F
X
F
o
l
a
a
a
a
a
a
a
a
a
a
a
a
a
"}
(18,1,1) = {"
a
a
a
a
a
a
a
a
a
a
a
T
T
T
T
T
T
T
T
T
T
T
T
T
q
q
q
F
q
q
q
F
l
r
l
l
l
a
a
a
a
a
a
a
a
a
a
a
a
a
"}
(19,1,1) = {"
a
a
a
a
a
a
a
a
a
a
a
T
T
T
T
T
T
T
T
T
T
T
T
T
q
f
F
F
F
S
q
F
F
X
F
o
l
a
a
a
a
a
a
a
a
a
a
a
a
a
"}
(20,1,1) = {"
a
a
a
a
a
a
a
a
a
a
a
T
T
T
T
T
T
T
T
T
T
q
q
q
q
q
N
E
q
q
P
l
l
l
l
l
l
a
a
a
a
a
a
a
a
a
a
a
a
a
"}
(21,1,1) = {"
a
a
a
a
a
a
a
a
a
a
a
T
T
T
T
T
T
T
T
T
T
q
G
Y
Y
Y
U
U
U
g
q
l
l
l
l
T
T
a
a
a
a
a
a
a
a
a
a
a
a
a
"}
(22,1,1) = {"
a
a
a
a
a
a
a
a
a
a
a
T
T
T
T
T
T
T
T
T
T
q
O
t
Z
b
y
U
U
e
M
F
F
F
l
T
T
a
a
a
a
a
a
a
a
a
a
a
a
a
"}
(23,1,1) = {"
a
a
a
a
a
a
a
a
a
a
a
T
T
T
T
T
T
T
T
T
T
q
U
u
u
u
U
U
U
U
l
F
F
F
l
T
T
a
a
a
a
a
a
a
a
a
a
a
a
a
"}
(24,1,1) = {"
a
a
a
a
a
a
a
a
a
a
a
q
q
q
q
q
q
q
q
T
T
q
U
U
U
U
U
U
U
U
l
F
F
F
l
T
T
a
a
a
a
a
a
a
a
a
a
a
a
a
"}
(25,1,1) = {"
a
a
a
a
a
a
a
a
a
a
a
q
w
w
w
w
w
J
q
T
T
q
U
U
U
U
U
U
U
U
l
F
F
F
l
T
T
a
a
a
a
a
a
a
a
a
a
a
a
a
"}
(26,1,1) = {"
a
a
a
a
a
a
a
a
a
a
a
q
w
w
w
w
w
V
i
q
q
N
R
U
U
U
U
U
U
U
l
F
F
F
l
T
T
a
a
a
a
a
a
a
a
a
a
a
a
a
"}
(27,1,1) = {"
a
a
a
a
a
a
a
a
a
a
a
q
w
w
w
w
w
d
E
F
F
E
U
U
U
U
U
U
U
g
q
l
l
l
l
T
T
a
a
a
a
a
a
a
a
a
a
a
a
a
"}
(28,1,1) = {"
a
a
a
a
a
a
a
a
a
a
a
q
w
w
w
w
w
V
i
q
q
N
U
U
U
U
U
U
U
U
q
l
l
l
l
T
T
a
a
a
a
a
a
a
a
a
a
a
a
a
"}
(29,1,1) = {"
a
a
a
a
a
a
a
a
a
a
a
q
w
w
w
w
w
V
q
T
T
q
U
U
U
U
U
U
U
U
N
F
H
L
l
T
T
a
a
a
a
a
a
a
a
a
a
a
a
a
"}
(30,1,1) = {"
a
a
a
a
a
a
a
a
a
a
a
q
q
q
q
q
q
q
q
T
T
q
U
m
m
m
m
U
U
U
E
F
H
L
l
T
T
a
a
a
a
a
a
a
a
a
a
a
a
a
"}
(31,1,1) = {"
a
a
a
a
a
a
a
a
a
a
a
T
T
T
T
T
T
T
T
T
T
q
U
h
h
h
h
U
U
U
q
F
H
L
l
T
T
a
a
a
a
a
a
a
a
a
a
a
a
a
"}
(32,1,1) = {"
a
a
a
a
a
a
a
a
a
a
a
T
T
T
T
T
T
T
T
T
T
q
U
U
U
U
h
U
U
U
q
l
l
l
l
T
T
a
a
a
a
a
a
a
a
a
a
a
a
a
"}
(33,1,1) = {"
a
a
a
a
a
a
a
a
a
a
a
T
T
T
T
T
T
T
T
T
T
q
R
s
C
Q
p
z
z
B
q
T
T
T
T
T
T
a
a
a
a
a
a
a
a
a
a
a
a
a
"}
(34,1,1) = {"
a
a
a
a
a
a
a
a
a
a
a
T
T
T
T
T
T
T
T
T
T
q
q
q
q
q
q
q
N
q
q
T
T
T
T
T
T
a
a
a
a
a
a
a
a
a
a
a
a
a
"}
(35,1,1) = {"
a
a
a
a
a
a
a
a
a
a
a
T
T
T
T
T
T
T
T
T
T
T
T
T
T
T
T
T
T
T
T
T
T
T
T
T
T
a
a
a
a
a
a
a
a
a
a
a
a
a
"}
(36,1,1) = {"
a
a
a
a
a
a
a
a
a
a
a
a
a
a
a
a
a
a
a
a
a
a
a
a
a
a
a
a
a
a
a
a
a
a
a
a
a
a
a
a
a
a
a
a
a
a
a
a
a
a
"}
(37,1,1) = {"
a
a
a
a
a
a
a
a
a
a
a
a
a
a
a
a
a
a
a
a
a
a
a
a
a
a
a
a
a
a
a
a
a
a
a
a
a
a
a
a
a
a
a
a
a
a
a
a
a
a
"}
(38,1,1) = {"
a
a
a
a
a
a
a
a
a
a
a
a
a
a
a
a
a
a
a
a
a
a
a
a
a
a
a
a
a
a
a
a
a
a
a
a
a
a
a
a
a
a
a
a
a
a
a
a
a
a
"}
(39,1,1) = {"
a
a
a
a
a
a
a
a
a
a
a
a
a
a
a
a
a
a
a
a
a
a
a
a
a
a
a
a
a
a
a
a
a
a
a
a
a
a
a
a
a
a
a
a
a
a
a
a
a
a
"}
(40,1,1) = {"
a
a
a
a
a
a
a
a
a
a
a
a
a
a
a
a
a
a
a
a
a
a
a
a
a
a
a
a
a
a
a
a
a
a
a
a
a
a
a
a
a
a
a
a
a
a
a
a
a
a
"}
(41,1,1) = {"
a
a
a
a
a
a
a
a
a
a
a
a
a
a
a
a
a
a
a
a
a
a
a
a
a
a
a
a
a
a
a
a
a
a
a
a
a
a
a
a
a
a
a
a
a
a
a
a
a
a
"}
(42,1,1) = {"
a
a
a
a
a
a
a
a
a
a
a
a
a
a
a
a
a
a
a
a
a
a
a
a
a
a
a
a
a
a
a
a
a
a
a
a
a
a
a
a
a
a
a
a
a
a
a
a
a
a
"}
(43,1,1) = {"
a
a
a
a
a
a
a
a
a
a
a
a
a
a
a
a
a
a
a
a
a
a
a
a
a
a
a
a
a
a
a
a
a
a
a
a
a
a
a
a
a
a
a
a
a
a
a
a
a
a
"}
(44,1,1) = {"
a
a
a
a
a
a
a
a
a
a
a
a
a
a
a
a
a
a
a
a
a
a
a
a
a
a
a
a
a
a
a
a
a
a
a
a
a
a
a
a
a
a
a
a
a
a
a
a
a
a
"}
(45,1,1) = {"
a
a
a
a
a
a
a
a
a
a
a
a
a
a
a
a
a
a
a
a
a
a
a
a
a
a
a
a
a
a
a
a
a
a
a
a
a
a
a
a
a
a
a
a
a
a
a
a
a
a
"}
(46,1,1) = {"
a
a
a
a
a
a
a
a
a
a
a
a
a
a
a
a
a
a
a
a
a
a
a
a
a
a
a
a
a
a
a
a
a
a
a
a
a
a
a
a
a
a
a
a
a
a
a
a
a
a
"}
(47,1,1) = {"
a
a
a
a
a
a
a
a
a
a
a
a
a
a
a
a
a
a
a
a
a
a
a
a
a
a
a
a
a
a
a
a
a
a
a
a
a
a
a
a
a
a
a
a
a
a
a
a
a
a
"}
(48,1,1) = {"
a
a
a
a
a
a
a
a
a
a
a
a
a
a
a
a
a
a
a
a
a
a
a
a
a
a
a
a
a
a
a
a
a
a
a
a
a
a
a
a
a
a
a
a
a
a
a
a
a
a
"}
(49,1,1) = {"
a
a
a
a
a
a
a
a
a
a
a
a
a
a
a
a
a
a
a
a
a
a
a
a
a
a
a
a
a
a
a
a
a
a
a
a
a
a
a
a
a
a
a
a
a
a
a
a
a
a
"}
(50,1,1) = {"
a
a
a
a
a
a
a
a
a
a
a
a
a
a
a
a
a
a
a
a
a
a
a
a
a
a
a
a
a
a
a
a
a
a
a
a
a
a
a
a
a
a
a
a
a
a
a
a
a
a
"}
