//MAP CONVERTED BY dmm2tgm.py THIS HEADER COMMENT PREVENTS RECONVERSION, DO NOT REMOVE
"a" = (
/obj/effect/landmark/cratespawn,
/turf/open/floor/plasteel/dark,
/area/city/backstreets_room)
"b" = (
/obj/effect/landmark/npc_reveal_sensor{
	sensor_id = "cages";
	cooldown_duration = 6000
	},
/turf/open/floor/plasteel/grimy,
/area/city/backstreets_room)
"d" = (
/obj/structure/table/optable,
/obj/effect/decal/cleanable/blood,
/obj/machinery/light{
	dir = 8
	},
/obj/effect/mob_spawn/human/corpse,
/turf/open/floor/plasteel/showroomfloor,
/area/city/backstreets_room)
"g" = (
/obj/item/folder/white{
	desc = "Looks to be remnants of the old G-Corp.";
	name = "Outdated G-Corp Folder"
	},
/obj/structure/chair/office,
/mob/living/simple_animal/hostile/clan/defender,
/turf/open/floor/plasteel/grimy,
/area/city/backstreets_room)
"h" = (
/turf/open/floor/plasteel/grimy,
/area/city/backstreets_room)
"j" = (
/turf/open/floor/plasteel/dark,
/area/city/backstreets_room)
"k" = (
/obj/structure/table/reinforced,
/obj/item/organ_storage,
/obj/item/storage/organbox,
/obj/structure/lootcrate/money,
/turf/open/floor/plasteel/showroomfloor,
/area/city/backstreets_room)
"l" = (
/obj/effect/decal/cleanable/blood/tracks{
	dir = 4
	},
/mob/living/simple_animal/hostile/clan/scout,
/obj/effect/landmark/npc_reveal_spawn{
	mobtype = /mob/living/simple_animal/npc/tinkerer;
	sensor_id = "cages"
	},
/turf/open/floor/plasteel/showroomfloor,
/area/city/backstreets_room)
"o" = (
/obj/effect/decal/cleanable/blood,
/mob/living/simple_animal/hostile/clan/drone,
/turf/open/floor/plasteel/showroomfloor,
/area/city/backstreets_room)
"p" = (
/obj/machinery/computer/operating{
	dir = 4
	},
/turf/open/floor/plasteel/showroomfloor,
/area/city/backstreets_room)
"q" = (
/obj/structure/table/reinforced/ctf,
/obj/item/tape/random,
/obj/item/tape/resurgence/first,
/turf/open/floor/plasteel/grimy,
/area/city/backstreets_room)
"r" = (
/obj/structure/table/reinforced/ctf,
/obj/item/paper_bin,
/obj/item/pen,
/obj/item/pen,
/turf/open/floor/plasteel/grimy,
/area/city/backstreets_room)
"u" = (
/obj/structure/table/reinforced/ctf,
/obj/item/taperecorder/empty,
/turf/open/floor/plasteel/grimy,
/area/city/backstreets_room)
"x" = (
/obj/effect/decal/cleanable/dirt/dust,
/turf/open/floor/plasteel/showroomfloor,
/area/city/backstreets_room)
"y" = (
/obj/structure/window/reinforced/spawner/north,
/mob/living/simple_animal/hostile/humanoid/rat/zippy,
/turf/open/floor/plasteel/dark,
/area/city/backstreets_room)
"B" = (
/obj/structure/window/reinforced/spawner/north,
/mob/living/simple_animal/hostile/humanoid/rat/pipe,
/turf/open/floor/plasteel/dark,
/area/city/backstreets_room)
"E" = (
/obj/structure/mineral_door/iron,
/turf/open/floor/plasteel/grimy,
/area/city/backstreets_room)
"H" = (
/turf/closed/indestructible/reinforced,
/area/city/backstreets_room)
"I" = (
/obj/machinery/door/window/brigdoor/northright,
/turf/open/floor/plasteel/dark,
/area/city/backstreets_room)
"K" = (
/obj/structure/chair/office,
/turf/open/floor/plasteel/grimy,
/area/city/backstreets_room)
"L" = (
/mob/living/simple_animal/hostile/humanoid/rat/zippy,
/turf/open/floor/plasteel/dark,
/area/city/backstreets_room)
"N" = (
/obj/structure/window/reinforced/spawner/north,
/obj/effect/landmark/cratespawn,
/turf/open/floor/plasteel/dark,
/area/city/backstreets_room)
"O" = (
/obj/structure/curtain,
/turf/open/floor/plasteel/grimy,
/area/city/backstreets_room)
"P" = (
/obj/structure/table/reinforced,
/obj/item/clothing/mask/surgical,
/obj/item/clothing/suit/apron/surgical{
	pixel_y = 5
	},
/obj/effect/decal/cleanable/dirt/dust,
/obj/effect/decal/cleanable/dirt/dust,
/obj/machinery/light{
	dir = 4;
	light_color = "#e8eaff"
	},
/obj/structure/lootcrate/money,
/turf/open/floor/plasteel/showroomfloor,
/area/city/backstreets_room)
"S" = (
/turf/open/floor/plasteel/showroomfloor,
/area/city/backstreets_room)
"W" = (
/mob/living/simple_animal/hostile/humanoid/rat/pipe,
/turf/open/floor/plasteel/dark,
/area/city/backstreets_room)
"Y" = (
/obj/structure/curtain,
/obj/machinery/iv_drip,
/turf/open/floor/plasteel/grimy,
/area/city/backstreets_room)

(1,1,1) = {"
H
H
H
H
H
H
H
H
H
H
"}
(2,1,1) = {"
H
p
d
Y
h
K
q
N
L
H
"}
(3,1,1) = {"
H
x
l
O
h
K
u
y
W
H
"}
(4,1,1) = {"
H
o
S
O
h
g
r
B
j
H
"}
(5,1,1) = {"
H
k
P
O
b
h
h
I
a
H
"}
(6,1,1) = {"
H
H
H
H
E
H
H
H
H
H
"}
