//MAP CONVERTED BY dmm2tgm.py THIS HEADER COMMENT PREVENTS RECONVERSION, DO NOT REMOVE
"a" = (
/obj/effect/decal/cleanable/dirt/dust,
/obj/machinery/atmospherics/components/unary/tank/air,
/turf/open/floor/plasteel/dark,
/area/city/backstreets_room)
"d" = (
/obj/effect/decal/cleanable/dirt/dust,
/obj/machinery/computer,
/turf/open/floor/plasteel/dark,
/area/city/backstreets_room)
"g" = (
/obj/effect/decal/cleanable/dirt/dust,
/obj/structure/sigsystem/tower{
	signal_range = 5;
	signal_code = 556
	},
/turf/open/floor/plasteel/dark,
/area/city/backstreets_room)
"h" = (
/obj/machinery/atmospherics/components/unary/cryo_cell{
	dir = 8
	},
/obj/effect/decal/cleanable/dirt/dust,
/obj/structure/sign/warning/coldtemp{
	pixel_x = -32
	},
/turf/open/floor/plasteel/dark,
/area/city/backstreets_room)
"l" = (
/obj/effect/decal/cleanable/dirt/dust,
/turf/open/floor/plasteel/dark,
/area/city/backstreets_room)
"m" = (
/obj/effect/decal/cleanable/dirt/dust,
/obj/machinery/computer,
/turf/open/floor/plasteel/freezer,
/area/city/backstreets_room)
"q" = (
/obj/effect/decal/cleanable/dirt/dust,
/obj/structure/sign/departments/w_corp{
	pixel_x = -32
	},
/turf/open/floor/plasteel/dark,
/area/city/backstreets_room)
"s" = (
/obj/machinery/atmospherics/components/unary/cryo_cell,
/obj/effect/decal/cleanable/dirt/dust,
/turf/open/floor/plasteel/dark,
/area/city/backstreets_room)
"x" = (
/turf/closed/indestructible/reinforced,
/area/city/backstreets_room)
"y" = (
/obj/effect/decal/cleanable/dirt/dust,
/obj/structure/sigsystem/deployer{
	atom_rename = "forgotten patient";
	atom_path = /mob/living/simple_animal/hostile/lovetown/slasher;
	spawn_flavor_text = "is released from cryo!";
	deploy_sound = 'sound/machines/airlock.ogg'
	},
/obj/structure/sigsystem/deployer{
	atom_path = /obj/effect/decal/cleanable/glass;
	pixel_x = 5
	},
/obj/structure/sigsystem/deployer{
	atom_path = /obj/effect/spawner/lootdrop/workshop_random;
	deploy_sound = 'sound/machines/cryo_warning.ogg';
	pixel_x = -5
	},
/turf/open/floor/plasteel/freezer,
/area/city/backstreets_room)
"E" = (
/obj/structure/sign/warning/chemdiamond{
	pixel_x = 32
	},
/obj/effect/decal/cleanable/dirt/dust,
/obj/machinery/atmospherics/components/unary/tank/air,
/turf/open/floor/plasteel/dark,
/area/city/backstreets_room)
"H" = (
/obj/effect/decal/cleanable/dirt/dust,
/obj/machinery/door/airlock/medical,
/turf/open/floor/plasteel/dark,
/area/city/backstreets_room)
"L" = (
/obj/effect/decal/cleanable/dirt/dust,
/obj/structure/sigsystem/deployer{
	atom_path = /obj/effect/spawner/lootdrop/workshop_random;
	pixel_x = 5;
	deploy_sound = 'sound/machines/cryo_warning.ogg'
	},
/obj/structure/sigsystem/deployer{
	atom_rename = "forgotten patient";
	atom_path = /mob/living/simple_animal/hostile/lovetown/slasher;
	spawn_flavor_text = "is released from cryo!";
	deploy_sound = 'sound/machines/airlock.ogg'
	},
/obj/structure/sigsystem/deployer{
	atom_path = /obj/effect/decal/cleanable/glass;
	pixel_x = -6
	},
/turf/open/floor/plasteel/freezer,
/area/city/backstreets_room)
"M" = (
/obj/machinery/atmospherics/components/unary/cryo_cell{
	autoeject = 0
	},
/obj/effect/decal/cleanable/dirt/dust,
/obj/structure/sigsystem/tower{
	signal_range = 5;
	signal_code = 556
	},
/turf/open/floor/plasteel/dark,
/area/city/backstreets_room)
"O" = (
/obj/effect/decal/cleanable/dirt/dust,
/obj/effect/decal/cleanable/molten_object,
/obj/structure/sigsystem/tower/button{
	pixel_x = -24;
	signal_code = 556
	},
/turf/open/floor/plasteel/dark,
/area/city/backstreets_room)
"P" = (
/obj/machinery/atmospherics/components/unary/cryo_cell{
	dir = 8
	},
/obj/effect/decal/cleanable/dirt/dust,
/turf/open/floor/plasteel/dark,
/area/city/backstreets_room)
"S" = (
/obj/effect/decal/cleanable/dirt/dust,
/obj/effect/decal/cleanable/molten_object,
/turf/open/floor/plasteel/freezer,
/area/city/backstreets_room)
"U" = (
/obj/effect/decal/cleanable/dirt/dust,
/obj/effect/decal/cleanable/molten_object,
/turf/open/floor/plasteel/dark,
/area/city/backstreets_room)
"Y" = (
/obj/effect/decal/cleanable/dirt/dust,
/turf/open/floor/plasteel/freezer,
/area/city/backstreets_room)
"Z" = (
/obj/machinery/atmospherics/components/unary/cryo_cell{
	dir = 4
	},
/obj/effect/decal/cleanable/dirt/dust,
/turf/open/floor/plasteel/dark,
/area/city/backstreets_room)

(1,1,1) = {"
x
x
x
x
x
x
x
x
x
x
"}
(2,1,1) = {"
x
P
O
q
l
h
d
l
l
x
"}
(3,1,1) = {"
x
s
Y
Y
g
L
m
U
l
x
"}
(4,1,1) = {"
x
M
y
S
l
Y
Y
l
l
x
"}
(5,1,1) = {"
x
Z
l
l
a
a
E
l
l
x
"}
(6,1,1) = {"
x
x
x
x
x
x
x
H
H
x
"}
