//MAP CONVERTED BY dmm2tgm.py THIS HEADER COMMENT PREVENTS RECONVERSION, DO NOT REMOVE
"a" = (
/turf/closed/indestructible/reinforced,
/area/space)
"f" = (
/obj/effect/decal/cleanable/blood,
/turf/open/floor/plasteel/showroomfloor,
/area/space)
"g" = (
/obj/effect/decal/cleanable/blood/tracks{
	dir = 4
	},
/turf/open/floor/plasteel/showroomfloor,
/area/space)
"k" = (
/obj/structure/curtain,
/turf/open/floor/plasteel/sepia,
/area/space)
"l" = (
/obj/machinery/vending/medical,
/obj/item/storage/backpack/duffelbag/med/surgery{
	pixel_y = 18
	},
/turf/open/floor/plasteel/showroomfloor,
/area/space)
"m" = (
/obj/structure/closet/crate/bin,
/obj/effect/decal/cleanable/dirt/dust,
/turf/open/floor/plasteel/sepia,
/area/space)
"s" = (
/obj/structure/chair/plastic{
	dir = 4
	},
/turf/open/floor/plasteel/sepia,
/area/space)
"u" = (
/obj/effect/spawner/randomsnackvend,
/turf/open/floor/plasteel/sepia,
/area/space)
"v" = (
/obj/structure/chair/plastic{
	dir = 4
	},
/obj/machinery/light/dim{
	dir = 8;
	pixel_x = null;
	pixel_y = null
	},
/turf/open/floor/plasteel/sepia,
/area/space)
"w" = (
/turf/open/floor/plasteel/sepia,
/area/space)
"x" = (
/obj/structure/chair/plastic{
	dir = 8
	},
/obj/machinery/light/dim{
	dir = 4
	},
/turf/open/floor/plasteel/sepia,
/area/space)
"z" = (
/turf/open/floor/plasteel/showroomfloor,
/area/space)
"B" = (
/obj/machinery/iv_drip,
/obj/effect/decal/cleanable/dirt/dust,
/turf/open/floor/plasteel/showroomfloor,
/area/space)
"C" = (
/obj/effect/decal/cleanable/dirt/dust,
/turf/open/floor/plasteel/sepia,
/area/space)
"D" = (
/obj/effect/spawner/randomcolavend,
/turf/open/floor/plasteel/sepia,
/area/space)
"E" = (
/obj/structure/table/reinforced,
/obj/item/clothing/mask/surgical,
/obj/item/clothing/suit/apron/surgical{
	pixel_y = 5
	},
/obj/effect/decal/cleanable/dirt/dust,
/obj/effect/decal/cleanable/dirt/dust,
/obj/machinery/light{
	dir = 4;
	light_color = "#e8eaff"
	},
/turf/open/floor/plasteel/showroomfloor,
/area/space)
"F" = (
/obj/machinery/computer/operating{
	dir = 4
	},
/turf/open/floor/plasteel/showroomfloor,
/area/space)
"G" = (
/obj/structure/curtain,
/obj/effect/decal/cleanable/dirt/dust,
/turf/open/floor/plasteel/sepia,
/area/space)
"S" = (
/obj/structure/table/reinforced,
/obj/item/organ_storage,
/obj/item/storage/organbox,
/turf/open/floor/plasteel/showroomfloor,
/area/space)
"T" = (
/obj/structure/mineral_door/wood,
/turf/open/floor/plasteel/sepia,
/area/space)
"U" = (
/obj/structure/table/optable,
/obj/effect/decal/cleanable/blood,
/obj/machinery/light{
	dir = 8
	},
/turf/open/floor/plasteel/showroomfloor,
/area/space)
"V" = (
/obj/effect/decal/cleanable/dirt/dust,
/obj/structure/chair/plastic{
	dir = 8
	},
/turf/open/floor/plasteel/sepia,
/area/space)
"X" = (
/obj/effect/decal/cleanable/dirt/dust,
/turf/open/floor/plasteel/showroomfloor,
/area/space)

(1,1,1) = {"
a
a
a
a
a
a
a
a
a
a
"}
(2,1,1) = {"
a
F
U
B
G
C
s
v
w
a
"}
(3,1,1) = {"
a
X
g
z
k
w
C
C
u
a
"}
(4,1,1) = {"
a
f
z
f
G
w
w
w
D
a
"}
(5,1,1) = {"
a
S
E
l
k
w
V
x
m
a
"}
(6,1,1) = {"
a
a
a
a
a
T
a
a
a
a
"}
