//MAP CONVERTED BY dmm2tgm.py THIS HEADER COMMENT PREVENTS RECONVERSION, DO NOT REMOVE
"a" = (
/turf/closed/indestructible/reinforced,
/area/city/backstreets_room)
"b" = (
/obj/effect/decal/cleanable/glass,
/obj/effect/turf_decal/siding/thinplating/light/end{
	dir = 1
	},
/obj/structure/sign/plaques/kiddie/perfect_man{
	pixel_x = 32
	},
/turf/open/floor/glass,
/area/city/backstreets_room)
"c" = (
/obj/effect/turf_decal/siding/thinplating/light{
	dir = 4
	},
/obj/machinery/light/dim{
	dir = 4
	},
/turf/open/floor/glass,
/area/city/backstreets_room)
"d" = (
/obj/structure/chair/pew/left{
	dir = 1
	},
/turf/open/floor/carpet/cyan,
/area/city/backstreets_room)
"e" = (
/obj/effect/turf_decal/siding/thinplating/light{
	dir = 4
	},
/obj/effect/turf_decal/siding/thinplating/light/corner{
	dir = 1
	},
/turf/open/floor/glass,
/area/city/backstreets_room)
"f" = (
/obj/structure/chair/pew/left{
	dir = 1
	},
/turf/open/floor/glass,
/area/city/backstreets_room)
"g" = (
/obj/structure/sign/poster/ripped,
/turf/closed/indestructible/reinforced,
/area/city/backstreets_room)
"h" = (
/obj/effect/decal/cleanable/glass,
/obj/effect/turf_decal/siding/thinplating/light/end,
/turf/open/floor/glass,
/area/city/backstreets_room)
"i" = (
/obj/machinery/light/dim,
/turf/open/floor/plasteel/chapel{
	dir = 1
	},
/area/city/backstreets_room)
"j" = (
/obj/machinery/light/dim{
	dir = 1
	},
/turf/open/floor/carpet/cyan,
/area/city/backstreets_room)
"k" = (
/obj/structure/mineral_door/iron,
/turf/open/floor/plasteel/chapel{
	dir = 1
	},
/area/city/backstreets_room)
"l" = (
/obj/structure/sign/poster/official/do_not_question,
/turf/closed/indestructible/reinforced,
/area/city/backstreets_room)
"m" = (
/obj/structure/table/wood/fancy/royalblue,
/obj/item/reagent_containers/food/drinks/bottle/holywater,
/obj/item/reagent_containers/hypospray/medipen/mental,
/obj/item/reagent_containers/hypospray/medipen/mental,
/turf/open/floor/plasteel/chapel,
/area/city/backstreets_room)
"n" = (
/obj/effect/decal/cleanable/glass,
/obj/effect/turf_decal/siding/thinplating/light/end{
	dir = 1
	},
/obj/structure/sign/plaques/kiddie/perfect_man{
	pixel_x = -32
	},
/turf/open/floor/glass,
/area/city/backstreets_room)
"o" = (
/obj/effect/decal/cleanable/glass,
/obj/effect/turf_decal/siding/thinplating/light{
	dir = 4
	},
/obj/effect/turf_decal/siding/thinplating/light/corner{
	dir = 8
	},
/turf/open/floor/glass,
/area/city/backstreets_room)
"p" = (
/turf/open/floor/carpet/cyan,
/area/city/backstreets_room)
"r" = (
/obj/effect/decal/cleanable/glass,
/obj/effect/turf_decal/siding/thinplating/light{
	dir = 8
	},
/obj/machinery/light/dim{
	dir = 8;
	pixel_x = null;
	pixel_y = null
	},
/turf/open/floor/glass,
/area/city/backstreets_room)
"v" = (
/obj/effect/decal/cleanable/glass,
/obj/effect/turf_decal/siding/thinplating/light{
	dir = 8
	},
/obj/effect/turf_decal/siding/thinplating/light/corner{
	dir = 6
	},
/turf/open/floor/glass,
/area/city/backstreets_room)
"w" = (
/obj/structure/table/wood/fancy/royalblue,
/obj/item/food/cake/holy_cake,
/turf/open/floor/plasteel/chapel{
	dir = 8
	},
/area/city/backstreets_room)
"x" = (
/obj/structure/chair/pew/right{
	dir = 1
	},
/turf/open/floor/carpet/cyan,
/area/city/backstreets_room)
"z" = (
/obj/structure/chair/pew/right{
	dir = 1
	},
/obj/effect/decal/cleanable/glass,
/turf/open/floor/glass,
/area/city/backstreets_room)
"A" = (
/mob/living/simple_animal/npc/priest,
/turf/open/floor/carpet/cyan,
/area/city/backstreets_room)
"C" = (
/obj/effect/turf_decal/siding/thinplating/light{
	dir = 8
	},
/obj/effect/turf_decal/siding/thinplating/light/corner{
	dir = 4
	},
/turf/open/floor/glass,
/area/city/backstreets_room)
"D" = (
/obj/structure/chair/pew/right{
	dir = 1
	},
/obj/effect/turf_decal/siding/thinplating/light{
	dir = 1
	},
/turf/open/floor/glass,
/area/city/backstreets_room)
"G" = (
/obj/structure/sacrificealtar,
/obj/item/storage/book/bible,
/turf/open/floor/carpet/cyan,
/area/city/backstreets_room)
"H" = (
/turf/open/floor/plasteel/chapel{
	dir = 4
	},
/area/city/backstreets_room)
"I" = (
/obj/structure/sign/poster/official/cleanliness,
/turf/closed/indestructible/reinforced,
/area/city/backstreets_room)
"K" = (
/obj/structure/chair/pew/right{
	dir = 1
	},
/obj/effect/turf_decal/siding/thinplating/light,
/turf/open/floor/glass,
/area/city/backstreets_room)
"P" = (
/turf/open/floor/plasteel/chapel{
	dir = 1
	},
/area/city/backstreets_room)
"Q" = (
/obj/effect/turf_decal/siding/thinplating/light/end,
/turf/open/floor/glass,
/area/city/backstreets_room)
"S" = (
/obj/structure/chair/pew/left{
	dir = 1
	},
/obj/effect/turf_decal/siding/thinplating/light,
/turf/open/floor/glass,
/area/city/backstreets_room)
"U" = (
/obj/structure/lootcrate/backstreets,
/obj/machinery/light/dim,
/turf/open/floor/plasteel/chapel{
	dir = 1
	},
/area/city/backstreets_room)
"V" = (
/obj/structure/sacrificealtar,
/turf/open/floor/carpet/cyan,
/area/city/backstreets_room)
"W" = (
/obj/structure/sign/departments/holy,
/turf/closed/indestructible/reinforced,
/area/city/backstreets_room)
"X" = (
/obj/item/flashlight/lantern{
	on = 1
	},
/turf/open/floor/carpet/cyan,
/area/city/backstreets_room)
"Y" = (
/obj/structure/chair/pew/left{
	dir = 1
	},
/obj/effect/turf_decal/siding/thinplating/light{
	dir = 1
	},
/turf/open/floor/glass,
/area/city/backstreets_room)

(1,1,1) = {"
a
I
a
a
a
a
g
a
l
a
"}
(2,1,1) = {"
a
j
p
n
C
r
v
Q
U
a
"}
(3,1,1) = {"
a
A
G
d
Y
f
S
P
w
a
"}
(4,1,1) = {"
a
X
V
x
D
z
K
H
m
a
"}
(5,1,1) = {"
a
j
p
b
e
c
o
h
i
a
"}
(6,1,1) = {"
a
a
a
a
a
g
a
W
k
W
"}
