//MAP CONVERTED BY dmm2tgm.py THIS HEADER COMMENT PREVENTS RECONVERSION, DO NOT REMOVE
"a" = (
/mob/living/simple_animal/hostile/lovetown/slasher,
/obj/structure/meatfloor,
/obj/effect/decal/cleanable/blood/tracks{
	dir = 10
	},
/turf/open/floor/plating/rust,
/area/city/backstreets_room)
"d" = (
/obj/effect/decal/cleanable/blood/gibs/core,
/turf/open/floor/plating/rust,
/area/city/backstreets_room)
"e" = (
/obj/structure/meatfloor,
/obj/effect/decal/cleanable/blood/tracks{
	dir = 8
	},
/turf/open/floor/plating/asteroid/basalt,
/area/city/backstreets_room)
"f" = (
/obj/structure/meatfloor,
/turf/open/floor/plating/asteroid/basalt,
/area/city/backstreets_room)
"g" = (
/obj/effect/decal/cleanable/blood/tracks,
/turf/open/floor/plating/rust,
/area/city/backstreets_room)
"j" = (
/obj/effect/decal/cleanable/blood/gibs/old,
/obj/effect/decal/cleanable/blood/tracks,
/turf/open/floor/plating/asteroid/basalt,
/area/city/backstreets_room)
"l" = (
/obj/structure/meatfloor,
/obj/structure/meatfloor,
/obj/effect/decal/cleanable/blood/tracks,
/turf/open/floor/plating/rust,
/area/city/backstreets_room)
"n" = (
/obj/structure/meatfloor,
/obj/effect/decal/cleanable/blood/gibs/core,
/turf/open/floor/plating/asteroid/basalt,
/area/city/backstreets_room)
"o" = (
/obj/structure/meatfloor,
/turf/open/floor/plating/rust,
/area/city/backstreets_room)
"p" = (
/obj/structure/meatfloor,
/obj/effect/mob_spawn/human/clown/corpse,
/turf/open/floor/plating/rust,
/area/city/backstreets_room)
"q" = (
/obj/structure/lootcrate/w_corp,
/turf/open/floor/plating/rust,
/area/city/backstreets_room)
"s" = (
/obj/structure/meatfloor,
/obj/structure/meatfloor,
/turf/open/floor/plating/asteroid/basalt,
/area/city/backstreets_room)
"u" = (
/obj/effect/decal/cleanable/blood/old,
/turf/open/floor/plating/rust,
/area/city/backstreets_room)
"v" = (
/obj/structure/meatfloor,
/obj/effect/decal/cleanable/blood/tracks{
	dir = 8
	},
/turf/open/floor/plating/rust,
/area/city/backstreets_room)
"x" = (
/turf/closed/indestructible/reinforced,
/area/city/backstreets_room)
"y" = (
/obj/structure/meatfloor,
/obj/effect/decal/cleanable/blood/tracks{
	dir = 10
	},
/turf/open/floor/plating/rust,
/area/city/backstreets_room)
"z" = (
/obj/effect/decal/cleanable/blood/gibs/down,
/turf/open/floor/plating/rust,
/area/city/backstreets_room)
"B" = (
/obj/effect/decal/cleanable/blood/footprints,
/obj/effect/decal/cleanable/blood/tracks{
	dir = 5
	},
/turf/open/floor/plating/rust,
/area/city/backstreets_room)
"F" = (
/obj/structure/meatfloor,
/obj/item/organ/tongue/bone,
/turf/open/floor/plating/rust,
/area/city/backstreets_room)
"G" = (
/obj/effect/decal/cleanable/blood/gibs/torso,
/obj/effect/decal/cleanable/blood/gibs/core,
/turf/open/floor/plating/rust,
/area/city/backstreets_room)
"H" = (
/obj/effect/decal/cleanable/blood/tracks,
/turf/open/floor/plating/asteroid/basalt,
/area/city/backstreets_room)
"I" = (
/mob/living/simple_animal/hostile/lovetown/slasher,
/obj/effect/decal/cleanable/blood/footprints,
/obj/effect/decal/cleanable/blood/tracks{
	dir = 10
	},
/turf/open/floor/plating/rust,
/area/city/backstreets_room)
"J" = (
/obj/effect/decal/cleanable/blood/tracks{
	dir = 5
	},
/turf/open/floor/plating/asteroid/basalt,
/area/city/backstreets_room)
"M" = (
/obj/effect/decal/cleanable/blood/footprints,
/obj/structure/lootcrate/money,
/turf/open/floor/plating/dirt,
/area/city/backstreets_room)
"N" = (
/mob/living/simple_animal/hostile/lovetown/shambler,
/obj/structure/meatfloor,
/turf/open/floor/plating/dirt,
/area/city/backstreets_room)
"P" = (
/obj/structure/meatfloor,
/obj/effect/decal/cleanable/blood/footprints,
/obj/effect/decal/cleanable/blood/footprints{
	dir = 8
	},
/obj/effect/decal/cleanable/blood/footprints{
	dir = 4;
	pixel_x = 10;
	pixel_y = -8
	},
/obj/effect/decal/cleanable/blood/footprints{
	dir = 8;
	pixel_x = -20
	},
/turf/open/floor/plating/rust,
/area/city/backstreets_room)
"R" = (
/mob/living/simple_animal/hostile/lovetown/slasher,
/obj/structure/meatfloor,
/turf/open/floor/plating/asteroid/basalt,
/area/city/backstreets_room)
"S" = (
/obj/effect/decal/cleanable/blood/gibs/core,
/turf/open/floor/plating/asteroid/basalt,
/area/city/backstreets_room)
"U" = (
/obj/structure/lootcrate/money,
/turf/open/floor/plating/rust,
/area/city/backstreets_room)
"X" = (
/obj/effect/decal/cleanable/blood/gibs/core,
/mob/living/simple_animal/hostile/lovetown/stabber,
/turf/open/floor/plating/asteroid/basalt,
/area/city/backstreets_room)
"Y" = (
/obj/structure/meatfloor,
/obj/effect/decal/cleanable/blood/tracks,
/turf/open/floor/plating/rust,
/area/city/backstreets_room)

(1,1,1) = {"
x
x
x
x
x
x
x
x
x
x
"}
(2,1,1) = {"
x
o
G
z
o
u
F
o
p
x
"}
(3,1,1) = {"
x
Y
a
g
l
Y
y
q
U
x
"}
(4,1,1) = {"
x
X
v
o
s
P
B
I
M
x
"}
(5,1,1) = {"
x
R
e
N
d
n
f
e
o
x
"}
(6,1,1) = {"
x
S
J
H
j
H
H
H
H
x
"}
