//MAP CONVERTED BY dmm2tgm.py THIS HEADER COMMENT PREVENTS RECONVERSION, DO NOT REMOVE
"a" = (
/turf/closed/indestructible/rock,
/area/space)
"c" = (
/obj/docking_port/stationary{
	dwidth = 3;
	height = 5;
	id = "quest_floor";
	name = "quest floor";
	width = 6
	},
/turf/open/floor/plasteel/elevatorshaft,
/area/space)
"l" = (
/turf/open/floor/plasteel/elevatorshaft,
/area/space)
"t" = (
/obj/machinery/door/window/brigdoor/southright{
	dir = 1
	},
/obj/effect/turf_decal/caution/stand_clear,
/obj/machinery/door/poddoor/preopen{
	id = "managerlockdown";
	name = "Manager's Office Lockdown Blast Door"
	},
/turf/open/floor/plasteel,
/area/space)
"G" = (
/obj/structure/railing{
	dir = 1
	},
/obj/effect/turf_decal/stripes/line{
	dir = 1
	},
/obj/machinery/door/poddoor/preopen{
	id = "managerlockdown";
	name = "Manager's Office Lockdown Blast Door"
	},
/turf/open/floor/plasteel/dark,
/area/space)
"R" = (
/obj/structure/railing{
	dir = 1
	},
/obj/machinery/light{
	dir = 4
	},
/obj/effect/turf_decal/stripes/line{
	dir = 1
	},
/obj/machinery/door/poddoor/preopen{
	id = "managerlockdown";
	name = "Manager's Office Lockdown Blast Door"
	},
/turf/open/floor/plasteel/dark,
/area/space)
"U" = (
/obj/structure/railing{
	dir = 1
	},
/obj/machinery/computer/shuttle/mining{
	dir = 4;
	name = "bus console";
	possible_destinations = "quest_floor";
	shuttleId = "quest"
	},
/obj/machinery/light{
	dir = 8
	},
/obj/effect/turf_decal/stripes/line{
	dir = 1
	},
/obj/machinery/door/poddoor/preopen{
	id = "managerlockdown";
	name = "Manager's Office Lockdown Blast Door"
	},
/turf/open/floor/plasteel/dark,
/area/space)

(1,1,1) = {"
a
a
a
a
a
a
a
a
a
a
a
a
a
a
a
a
a
a
a
a
"}
(2,1,1) = {"
a
a
a
a
a
a
a
a
a
a
a
a
a
a
a
a
a
a
a
a
"}
(3,1,1) = {"
a
a
a
a
a
a
a
a
a
a
a
a
a
a
a
a
a
a
a
a
"}
(4,1,1) = {"
a
a
a
a
a
a
a
a
a
a
a
a
a
a
a
a
a
a
a
a
"}
(5,1,1) = {"
a
a
a
a
a
a
a
a
a
a
a
a
a
a
a
a
a
a
a
a
"}
(6,1,1) = {"
a
a
a
a
a
a
a
a
a
a
a
a
a
a
a
a
a
a
a
a
"}
(7,1,1) = {"
a
a
a
a
a
a
a
a
a
a
a
a
a
a
a
a
a
a
a
a
"}
(8,1,1) = {"
a
l
l
l
l
l
U
a
a
a
a
a
a
a
a
a
a
a
a
a
"}
(9,1,1) = {"
a
l
l
l
l
l
G
a
a
a
a
a
a
a
a
a
a
a
a
a
"}
(10,1,1) = {"
a
l
l
l
l
c
t
a
a
a
a
a
a
a
a
a
a
a
a
a
"}
(11,1,1) = {"
a
l
l
l
l
l
G
a
a
a
a
a
a
a
a
a
a
a
a
a
"}
(12,1,1) = {"
a
l
l
l
l
l
R
a
a
a
a
a
a
a
a
a
a
a
a
a
"}
(13,1,1) = {"
a
a
a
a
a
a
a
a
a
a
a
a
a
a
a
a
a
a
a
a
"}
(14,1,1) = {"
a
a
a
a
a
a
a
a
a
a
a
a
a
a
a
a
a
a
a
a
"}
(15,1,1) = {"
a
a
a
a
a
a
a
a
a
a
a
a
a
a
a
a
a
a
a
a
"}
(16,1,1) = {"
a
a
a
a
a
a
a
a
a
a
a
a
a
a
a
a
a
a
a
a
"}
(17,1,1) = {"
a
a
a
a
a
a
a
a
a
a
a
a
a
a
a
a
a
a
a
a
"}
(18,1,1) = {"
a
a
a
a
a
a
a
a
a
a
a
a
a
a
a
a
a
a
a
a
"}
(19,1,1) = {"
a
a
a
a
a
a
a
a
a
a
a
a
a
a
a
a
a
a
a
a
"}
(20,1,1) = {"
a
a
a
a
a
a
a
a
a
a
a
a
a
a
a
a
a
a
a
a
"}
