//MAP CONVERTED BY dmm2tgm.py THIS HEADER COMMENT PREVENTS RECONVERSION, DO NOT REMOVE
"a" = (
/turf/closed/indestructible/reinforced,
/area/city/backstreets_room)
"c" = (
/obj/structure/chair/office,
/mob/living/simple_animal/hostile/clan/scout,
/obj/effect/decal/cleanable/dirt/dust,
/turf/open/floor/carpet/red,
/area/city/backstreets_room)
"e" = (
/obj/structure/table/reinforced,
/obj/effect/decal/cleanable/dirt/dust,
/obj/item/stack/spacecash/c10,
/turf/open/floor/material,
/area/city/backstreets_room)
"g" = (
/obj/effect/decal/cleanable/dirt/dust,
/mob/living/simple_animal/hostile/clan/defender,
/obj/effect/landmark/npc_reveal_sensor{
	sensor_id = "mechs";
	cooldown_duration = 6000
	},
/turf/open/floor/carpet/red,
/area/city/backstreets_room)
"h" = (
/obj/structure/chair/office{
	dir = 1
	},
/mob/living/simple_animal/hostile/clan/scout,
/obj/effect/decal/cleanable/dirt/dust,
/turf/open/floor/carpet/red,
/area/city/backstreets_room)
"k" = (
/turf/open/floor/material,
/area/city/backstreets_room)
"l" = (
/obj/structure/mecha_wreckage/reticence,
/obj/structure/window/reinforced/spawner/north,
/obj/structure/window/reinforced/spawner/west,
/turf/open/floor/mech_bay_recharge_floor,
/area/city/backstreets_room)
"n" = (
/obj/structure/mineral_door/iron,
/turf/open/floor/material,
/area/city/backstreets_room)
"p" = (
/mob/living/simple_animal/hostile/clan/drone,
/obj/effect/decal/cleanable/dirt/dust,
/turf/open/floor/carpet/red,
/area/city/backstreets_room)
"r" = (
/obj/structure/mecha_wreckage/reticence,
/obj/structure/window/reinforced/spawner/west,
/obj/structure/window/reinforced/spawner,
/turf/open/floor/mech_bay_recharge_floor,
/area/city/backstreets_room)
"w" = (
/obj/structure/chair/office{
	dir = 1
	},
/mob/living/simple_animal/hostile/clan/scout,
/obj/effect/landmark/npc_reveal_spawn{
	sensor_id = "mechs";
	mobtype = /mob/living/simple_animal/npc/tinkerer
	},
/turf/open/floor/carpet/red,
/area/city/backstreets_room)
"A" = (
/obj/structure/frame/computer,
/turf/open/floor/carpet/red,
/area/city/backstreets_room)
"E" = (
/turf/open/floor/carpet/red,
/area/city/backstreets_room)
"H" = (
/obj/structure/mecha_wreckage/reticence,
/obj/structure/window/reinforced/spawner/east,
/obj/structure/window/reinforced/spawner/north,
/turf/open/floor/mech_bay_recharge_floor,
/area/city/backstreets_room)
"I" = (
/obj/structure/chair/office,
/turf/open/floor/carpet/red,
/area/city/backstreets_room)
"J" = (
/obj/effect/decal/cleanable/dirt/dust,
/turf/open/floor/carpet/red,
/area/city/backstreets_room)
"L" = (
/obj/structure/mecha_wreckage/reticence,
/obj/structure/window/reinforced/spawner/east,
/obj/structure/window/reinforced/spawner,
/obj/effect/decal/cleanable/dirt/dust,
/turf/open/floor/mech_bay_recharge_floor,
/area/city/backstreets_room)
"O" = (
/obj/effect/landmark/cratespawn/corpo,
/turf/open/floor/carpet/red,
/area/city/backstreets_room)
"U" = (
/obj/structure/table/reinforced,
/obj/item/tape/resurgence/new_library,
/turf/open/floor/material,
/area/city/backstreets_room)
"V" = (
/obj/structure/frame/computer{
	dir = 1
	},
/obj/effect/decal/cleanable/dirt/dust,
/turf/open/floor/carpet/red,
/area/city/backstreets_room)
"W" = (
/obj/effect/decal/cleanable/dirt/dust,
/turf/open/floor/material,
/area/city/backstreets_room)
"X" = (
/obj/structure/table/reinforced,
/obj/item/taperecorder/empty,
/turf/open/floor/material,
/area/city/backstreets_room)
"Y" = (
/obj/effect/landmark/cratespawn/corpo,
/obj/effect/decal/cleanable/dirt/dust,
/turf/open/floor/carpet/red,
/area/city/backstreets_room)
"Z" = (
/obj/structure/table/reinforced,
/obj/item/stack/spacecash/c10,
/obj/item/stack/spacecash/c10,
/obj/item/paper_bin,
/turf/open/floor/material,
/area/city/backstreets_room)

(1,1,1) = {"
a
a
a
a
a
n
a
a
a
a
"}
(2,1,1) = {"
a
L
Y
J
E
g
E
J
H
a
"}
(3,1,1) = {"
a
A
w
k
Z
X
W
I
V
a
"}
(4,1,1) = {"
a
A
h
W
U
e
W
c
V
a
"}
(5,1,1) = {"
a
r
E
J
E
E
p
O
l
a
"}
(6,1,1) = {"
a
a
a
a
a
a
a
a
a
a
"}
