"a" = (/obj/structure/mineral_door/iron,/turf/open/floor/plasteel/chapel{dir = 1},/area/city/backstreets_room)
"c" = (/obj/effect/decal/cleanable/glass,/obj/effect/turf_decal/siding/thinplating/light/end{dir = 1},/obj/structure/sign/plaques/kiddie/perfect_man{pixel_x = -32},/turf/open/floor/glass,/area/city/backstreets_room)
"d" = (/obj/structure/chair/pew/right{dir = 1},/turf/open/floor/carpet/cyan,/area/city/backstreets_room)
"f" = (/mob/living/simple_animal/npc/priest,/turf/open/floor/carpet/cyan,/area/city/backstreets_room)
"g" = (/obj/effect/turf_decal/siding/thinplating/light{dir = 4},/turf/open/floor/glass,/area/city/backstreets_room)
"h" = (/obj/effect/turf_decal/siding/thinplating/light/end,/turf/open/floor/glass,/area/city/backstreets_room)
"j" = (/obj/structure/table/wood/fancy/royalblue,/obj/item/food/cake/holy_cake,/turf/open/floor/plasteel/chapel{dir = 8},/area/city/backstreets_room)
"k" = (/obj/structure/chair/pew/right{dir = 1},/obj/effect/turf_decal/siding/thinplating/light{dir = 1},/turf/open/floor/glass,/area/city/backstreets_room)
"m" = (/obj/effect/turf_decal/siding/thinplating/light{dir = 4},/obj/effect/turf_decal/siding/thinplating/light/corner{dir = 1},/turf/open/floor/glass,/area/city/backstreets_room)
"n" = (/turf/open/floor/plasteel/chapel{dir = 4},/area/city/backstreets_room)
"o" = (/obj/effect/decal/cleanable/glass,/obj/effect/turf_decal/siding/thinplating/light/end,/turf/open/floor/glass,/area/city/backstreets_room)
"q" = (/obj/effect/turf_decal/siding/thinplating/light{dir = 8},/obj/effect/turf_decal/siding/thinplating/light/corner{dir = 4},/turf/open/floor/glass,/area/city/backstreets_room)
"r" = (/turf/closed/indestructible/reinforced,/area/city/backstreets_room)
"s" = (/turf/open/floor/carpet/cyan,/area/city/backstreets_room)
"t" = (/obj/structure/chair/pew/left{dir = 1},/obj/effect/turf_decal/siding/thinplating/light{dir = 1},/turf/open/floor/glass,/area/city/backstreets_room)
"u" = (/obj/structure/sign/poster/official/cleanliness,/turf/closed/indestructible/reinforced,/area/city/backstreets_room)
"v" = (/obj/structure/chair/pew/right{dir = 1},/obj/effect/decal/cleanable/glass,/turf/open/floor/glass,/area/city/backstreets_room)
"x" = (/obj/structure/chair/pew/left{dir = 1},/turf/open/floor/glass,/area/city/backstreets_room)
"A" = (/obj/structure/sign/poster/official/do_not_question,/turf/closed/indestructible/reinforced,/area/city/backstreets_room)
"C" = (/obj/structure/sign/poster/ripped,/turf/closed/indestructible/reinforced,/area/city/backstreets_room)
"E" = (/obj/effect/decal/cleanable/glass,/obj/effect/turf_decal/siding/thinplating/light/end{dir = 1},/obj/structure/sign/plaques/kiddie/perfect_man{pixel_x = 32},/turf/open/floor/glass,/area/city/backstreets_room)
"F" = (/obj/structure/lootcrate/backstreets,/turf/open/floor/plasteel/chapel{dir = 1},/area/city/backstreets_room)
"G" = (/obj/structure/chair/pew/right{dir = 1},/obj/effect/turf_decal/siding/thinplating/light,/turf/open/floor/glass,/area/city/backstreets_room)
"I" = (/obj/effect/decal/cleanable/glass,/obj/effect/turf_decal/siding/thinplating/light{dir = 8},/turf/open/floor/glass,/area/city/backstreets_room)
"K" = (/obj/structure/chair/pew/left{dir = 1},/obj/effect/turf_decal/siding/thinplating/light,/turf/open/floor/glass,/area/city/backstreets_room)
"Q" = (/obj/effect/decal/cleanable/glass,/obj/effect/turf_decal/siding/thinplating/light{dir = 4},/obj/effect/turf_decal/siding/thinplating/light/corner{dir = 8},/turf/open/floor/glass,/area/city/backstreets_room)
"R" = (/obj/structure/sacrificealtar,/turf/open/floor/carpet/cyan,/area/city/backstreets_room)
"S" = (/obj/structure/chair/pew/left{dir = 1},/turf/open/floor/carpet/cyan,/area/city/backstreets_room)
"U" = (/obj/structure/sign/departments/holy,/turf/closed/indestructible/reinforced,/area/city/backstreets_room)
"V" = (/turf/open/floor/plasteel/chapel{dir = 1},/area/city/backstreets_room)
"W" = (/obj/structure/sacrificealtar,/obj/item/storage/book/bible,/turf/open/floor/carpet/cyan,/area/city/backstreets_room)
"Y" = (/obj/structure/table/wood/fancy/royalblue,/obj/item/reagent_containers/food/drinks/bottle/holywater,/turf/open/floor/plasteel/chapel,/area/city/backstreets_room)
"Z" = (/obj/effect/decal/cleanable/glass,/obj/effect/turf_decal/siding/thinplating/light{dir = 8},/obj/effect/turf_decal/siding/thinplating/light/corner{dir = 6},/turf/open/floor/glass,/area/city/backstreets_room)

(1,1,1) = {"
rrrrrr
usfssr
rsWRsr
rcSdEr
rqtkmr
rIxvgC
CZKGQr
UhVnor
anjYFA
Urrrrr
"}
