//MAP CONVERTED BY dmm2tgm.py THIS HEADER COMMENT PREVENTS RECONVERSION, DO NOT REMOVE
"ai" = (
/obj/structure/table/wood/fancy/orange,
/obj/item/ego_weapon/city/bladelineage,
/obj/effect/decal/cleanable/blood/drip,
/turf/open/floor/wood,
/area/city/backstreets_room)
"av" = (
/obj/structure/easel,
/obj/item/canvas,
/turf/open/floor/plating/dirt/jungle/wasteland,
/area/city/backstreets_room)
"aL" = (
/obj/structure/bookcase/random/nonfiction,
/obj/item/flashlight/spotlight,
/turf/open/indestructible/hotelwood,
/area/city/backstreets_room)
"aN" = (
/obj/effect/decal/cleanable/blood/tracks,
/obj/effect/decal/cleanable/blood/gibs/old,
/turf/open/floor/wood,
/area/city/backstreets_room)
"bf" = (
/obj/structure/table/wood,
/obj/effect/turf_decal/siding/wood/corner{
	dir = 4
	},
/turf/open/indestructible/hotelwood,
/area/city/backstreets_room)
"bK" = (
/obj/structure/alien/resin/wall/creature,
/turf/open/space/basic,
/area/city/backstreets_room)
"cf" = (
/obj/machinery/door/airlock/wood,
/turf/open/indestructible/hotelwood,
/area/city/backstreets_room)
"ct" = (
/obj/item/canvas,
/obj/item/flashlight/spotlight,
/turf/open/floor/plating/dirt/jungle/wasteland,
/area/city/backstreets_room)
"cH" = (
/obj/item/flashlight/spotlight,
/turf/open/indestructible/hotelwood,
/area/city/backstreets_room)
"cT" = (
/obj/item/flashlight/spotlight,
/obj/effect/turf_decal/siding/wood{
	dir = 1
	},
/obj/effect/turf_decal/siding/wood,
/turf/open/indestructible/hotelwood,
/area/city/backstreets_room)
"dG" = (
/obj/structure/bookcase/random/fiction,
/turf/closed/indestructible/wood,
/area/city/backstreets_room)
"dI" = (
/turf/closed/indestructible/wood,
/area/city/backstreets_room)
"eB" = (
/obj/structure/sink{
	dir = 8;
	pixel_x = 14;
	pixel_y = 2
	},
/turf/open/indestructible/hotelwood,
/area/city/backstreets_room)
"eH" = (
/obj/structure/window/reinforced/fulltile/indestructable,
/turf/open/floor/pod/dark,
/area/city/backstreets_room)
"eV" = (
/obj/item/flashlight/spotlight,
/turf/open/floor/plating/dirt/jungle/wasteland,
/area/city/backstreets_room)
"fP" = (
/obj/structure/chair/wood{
	dir = 4
	},
/obj/item/toy/plush/hod,
/turf/open/floor/wood,
/area/city/backstreets_room)
"gc" = (
/obj/structure/table/wood/fancy/orange,
/obj/item/book/random,
/turf/open/floor/wood,
/area/city/backstreets_room)
"gg" = (
/obj/effect/turf_decal/siding/wood/corner,
/obj/effect/turf_decal/siding/wood/corner{
	dir = 8
	},
/turf/open/indestructible/hotelwood,
/area/city/backstreets_room)
"hL" = (
/obj/effect/turf_decal/siding/wood{
	dir = 1
	},
/obj/effect/turf_decal/siding/wood/corner{
	dir = 1
	},
/turf/open/indestructible/hotelwood,
/area/city/backstreets_room)
"iK" = (
/obj/effect/turf_decal/trimline/purple/filled/line{
	dir = 10
	},
/turf/open/floor/pod/dark,
/area/city/backstreets_room)
"jc" = (
/obj/structure/table/wood,
/obj/item/book/random{
	pixel_x = -5
	},
/obj/effect/turf_decal/siding/wood/corner{
	dir = 2
	},
/turf/open/indestructible/hotelwood,
/area/city/backstreets_room)
"jq" = (
/obj/effect/decal/cleanable/vomit,
/turf/open/floor/plating/dirt/jungle/wasteland,
/area/city/backstreets_room)
"jI" = (
/obj/item/book,
/obj/item/book{
	pixel_y = 9;
	pixel_x = 5
	},
/obj/item/book{
	pixel_y = -4;
	pixel_x = -8
	},
/obj/item/book{
	pixel_y = -8;
	pixel_x = 8
	},
/obj/effect/decal/cleanable/vomit,
/turf/open/floor/plating/dirt/jungle/wasteland,
/area/city/backstreets_room)
"jS" = (
/obj/machinery/computer/camera_advanced/abductor,
/obj/effect/turf_decal/trimline/purple/filled/line{
	dir = 9
	},
/turf/open/floor/pod/dark,
/area/city/backstreets_room)
"ky" = (
/obj/structure/table/wood,
/obj/item/toy/plush/malkuth,
/obj/effect/turf_decal/siding/wood/corner{
	dir = 1
	},
/obj/item/flashlight/spotlight,
/turf/open/indestructible/hotelwood,
/area/city/backstreets_room)
"kN" = (
/obj/item/reagent_containers/food/drinks/beer{
	pixel_x = 11;
	pixel_y = -9
	},
/turf/open/floor/plating/dirt/jungle/wasteland,
/area/city/backstreets_room)
"li" = (
/obj/item/flashlight/spotlight,
/obj/effect/turf_decal/siding/wood{
	dir = 1
	},
/turf/open/indestructible/hotelwood,
/area/city/backstreets_room)
"mv" = (
/obj/structure/table/wood/fancy/orange,
/obj/item/book/random{
	pixel_x = 7
	},
/turf/open/floor/wood,
/area/city/backstreets_room)
"mP" = (
/obj/structure/table/wood,
/turf/open/indestructible/hotelwood,
/area/city/backstreets_room)
"nt" = (
/obj/effect/turf_decal/siding/wood/corner{
	dir = 4
	},
/obj/structure/fireplace,
/turf/open/indestructible/hotelwood,
/area/city/backstreets_room)
"nu" = (
/obj/structure/table/optable/abductor,
/obj/effect/turf_decal/trimline/purple/filled/line{
	dir = 5
	},
/turf/open/floor/pod/dark,
/area/city/backstreets_room)
"nX" = (
/obj/effect/turf_decal/trimline/purple/filled/corner,
/turf/open/floor/pod/dark,
/area/city/backstreets_room)
"pJ" = (
/obj/structure/table/wood,
/obj/item/book/random{
	pixel_y = 2;
	pixel_x = 7
	},
/turf/open/indestructible/hotelwood,
/area/city/backstreets_room)
"pL" = (
/turf/open/floor/wood,
/area/city/backstreets_room)
"pT" = (
/obj/item/book/random,
/obj/structure/displaycase/noalert,
/turf/open/indestructible/hotelwood,
/area/city/backstreets_room)
"re" = (
/obj/effect/turf_decal/siding/wood{
	dir = 8
	},
/turf/open/indestructible/hotelwood,
/area/city/backstreets_room)
"so" = (
/obj/effect/turf_decal/siding/wood{
	dir = 8
	},
/obj/effect/turf_decal/siding/wood/corner{
	dir = 1
	},
/obj/structure/fireplace,
/turf/open/indestructible/hotelwood,
/area/city/backstreets_room)
"sN" = (
/obj/item/flashlight/spotlight,
/obj/effect/turf_decal/siding/wood{
	dir = 1
	},
/obj/effect/turf_decal/siding/wood/corner{
	dir = 4
	},
/turf/open/indestructible/hotelwood,
/area/city/backstreets_room)
"to" = (
/obj/item/canvas,
/obj/effect/decal/cleanable/vomit,
/turf/open/floor/plating/dirt/jungle/wasteland,
/area/city/backstreets_room)
"tK" = (
/obj/effect/turf_decal/trimline/purple/filled/line{
	dir = 6
	},
/obj/item/flashlight/spotlight,
/turf/open/floor/pod/dark,
/area/city/backstreets_room)
"tO" = (
/obj/effect/turf_decal/siding/wood/corner{
	dir = 8
	},
/obj/effect/turf_decal/siding/wood/corner{
	dir = 1
	},
/turf/open/indestructible/hotelwood,
/area/city/backstreets_room)
"ui" = (
/obj/item/reagent_containers/food/drinks/beer{
	pixel_x = -10;
	pixel_y = -7
	},
/obj/item/book{
	pixel_y = 3;
	pixel_x = 23
	},
/turf/open/floor/plating/dirt/jungle/wasteland,
/area/city/backstreets_room)
"uv" = (
/obj/effect/decal/cleanable/blood/drip,
/turf/open/floor/wood,
/area/city/backstreets_room)
"uN" = (
/obj/item/book/random,
/obj/item/book/random{
	pixel_y = 2
	},
/obj/item/book/random{
	pixel_y = 2;
	pixel_x = 7
	},
/obj/item/book/random{
	pixel_x = -5
	},
/obj/item/book/random{
	pixel_x = 7
	},
/obj/structure/table/wood,
/obj/item/flashlight/spotlight,
/turf/open/indestructible/hotelwood,
/area/city/backstreets_room)
"vm" = (
/obj/structure/closet/abductor,
/obj/item/slimepotion/speed,
/obj/effect/turf_decal/trimline/purple/filled/line{
	dir = 1
	},
/turf/open/floor/pod/dark,
/area/city/backstreets_room)
"vT" = (
/obj/structure/table/wood/fancy/orange,
/obj/item/book/codex_gigas{
	pixel_y = 5;
	pixel_x = -4
	},
/turf/open/floor/wood,
/area/city/backstreets_room)
"wV" = (
/obj/effect/turf_decal/siding/wood/corner{
	dir = 4
	},
/turf/open/indestructible/hotelwood,
/area/city/backstreets_room)
"xg" = (
/obj/structure/window/reinforced/fulltile/indestructable,
/turf/open/indestructible/hotelwood,
/area/city/backstreets_room)
"xi" = (
/turf/open/space/basic,
/area/space)
"xW" = (
/obj/effect/turf_decal/siding/wood{
	dir = 8
	},
/obj/item/flashlight/spotlight,
/turf/open/indestructible/hotelwood,
/area/city/backstreets_room)
"yk" = (
/obj/effect/turf_decal/siding/wood/corner{
	dir = 4
	},
/obj/effect/turf_decal/siding/wood/corner{
	dir = 2
	},
/turf/open/indestructible/hotelwood,
/area/city/backstreets_room)
"yW" = (
/obj/effect/turf_decal/siding/wood/corner{
	dir = 4
	},
/obj/effect/turf_decal/siding/wood/corner{
	dir = 1
	},
/turf/open/indestructible/hotelwood,
/area/city/backstreets_room)
"zK" = (
/obj/effect/turf_decal/siding/wood,
/obj/effect/turf_decal/siding/wood,
/turf/open/indestructible/hotelwood,
/area/city/backstreets_room)
"zT" = (
/obj/machinery/abductor/pad,
/obj/effect/turf_decal/trimline/purple/filled/line,
/turf/open/floor/pod/dark,
/area/city/backstreets_room)
"Ai" = (
/obj/structure/fireplace,
/turf/open/indestructible/hotelwood,
/area/city/backstreets_room)
"AA" = (
/obj/effect/turf_decal/siding/wood{
	dir = 1
	},
/obj/structure/fireplace,
/turf/open/indestructible/hotelwood,
/area/city/backstreets_room)
"AC" = (
/obj/effect/turf_decal/siding/wood/corner{
	dir = 8
	},
/turf/open/indestructible/hotelwood,
/area/city/backstreets_room)
"Cn" = (
/obj/structure/falsewall/plastitanium,
/turf/open/space/basic,
/area/city/backstreets_room)
"Cs" = (
/obj/structure/chair/wood{
	dir = 4
	},
/obj/effect/turf_decal/siding/wood{
	dir = 1
	},
/turf/open/indestructible/hotelwood,
/area/city/backstreets_room)
"Cx" = (
/obj/item/canvas,
/obj/item/reagent_containers/pill/maintenance,
/turf/open/floor/plating/dirt/jungle/wasteland,
/area/city/backstreets_room)
"CM" = (
/obj/structure/chair/wood{
	dir = 4
	},
/obj/effect/turf_decal/siding/wood,
/turf/open/indestructible/hotelwood,
/area/city/backstreets_room)
"EY" = (
/obj/item/mop,
/obj/structure/mopbucket,
/obj/effect/turf_decal/siding/wood/corner{
	dir = 2
	},
/turf/open/indestructible/hotelwood,
/area/city/backstreets_room)
"Fc" = (
/obj/structure/chair/wood{
	dir = 1
	},
/obj/item/toy/plush/bongbong,
/turf/open/floor/wood,
/area/city/backstreets_room)
"FS" = (
/obj/effect/turf_decal/trimline/purple/filled/corner{
	dir = 8
	},
/turf/open/floor/pod/dark,
/area/city/backstreets_room)
"FT" = (
/obj/structure/closet/abductor,
/obj/item/toy/plush/myo,
/obj/effect/turf_decal/trimline/purple/filled/line{
	dir = 1
	},
/turf/open/floor/pod/dark,
/area/city/backstreets_room)
"Ht" = (
/obj/effect/turf_decal/siding/wood{
	dir = 4
	},
/turf/open/indestructible/hotelwood,
/area/city/backstreets_room)
"Hx" = (
/obj/effect/turf_decal/siding/wood{
	dir = 1
	},
/obj/effect/turf_decal/siding/wood,
/turf/open/indestructible/hotelwood,
/area/city/backstreets_room)
"Il" = (
/obj/effect/turf_decal/siding/wood/corner{
	dir = 1
	},
/obj/structure/fireplace,
/turf/open/indestructible/hotelwood,
/area/city/backstreets_room)
"In" = (
/obj/effect/turf_decal/siding/wood{
	dir = 1
	},
/turf/open/indestructible/hotelwood,
/area/city/backstreets_room)
"IM" = (
/obj/structure/table/wood,
/obj/machinery/chem_dispenser/drinks/beer,
/turf/open/floor/plating/dirt/jungle/wasteland,
/area/city/backstreets_room)
"IW" = (
/obj/effect/turf_decal/siding/wood,
/obj/effect/turf_decal/siding/wood{
	dir = 1
	},
/turf/open/indestructible/hotelwood,
/area/city/backstreets_room)
"IZ" = (
/obj/item/toy/plush/yesod,
/obj/item/gun/ego_gun/pistol/solemnlament{
	pixel_y = -7;
	pixel_x = -13
	},
/obj/item/gun/ego_gun/pistol/solemnvow{
	pixel_x = 18;
	pixel_y = -7
	},
/obj/effect/turf_decal/trimline/purple/filled/line{
	dir = 1
	},
/turf/open/floor/pod/dark,
/area/city/backstreets_room)
"Jz" = (
/obj/structure/chair/wood{
	dir = 8
	},
/obj/item/toy/plush/yuri,
/turf/open/floor/wood,
/area/city/backstreets_room)
"JZ" = (
/obj/effect/turf_decal/siding/wood/corner{
	dir = 1
	},
/turf/open/indestructible/hotelwood,
/area/city/backstreets_room)
"KL" = (
/obj/effect/turf_decal/siding/wood{
	dir = 4
	},
/obj/item/flashlight/spotlight,
/turf/open/indestructible/hotelwood,
/area/city/backstreets_room)
"Lk" = (
/obj/item/reagent_containers/pill/maintenance,
/turf/open/floor/plating/dirt/jungle/wasteland,
/area/city/backstreets_room)
"Lx" = (
/obj/item/flashlight/spotlight,
/obj/structure/displaycase,
/obj/item/flashlight/lantern,
/turf/open/floor/wood,
/area/city/backstreets_room)
"LU" = (
/turf/open/floor/pod/dark,
/area/city/backstreets_room)
"NZ" = (
/obj/structure/chair/wood{
	dir = 8
	},
/turf/open/indestructible/hotelwood,
/area/city/backstreets_room)
"Oy" = (
/obj/structure/window/reinforced/fulltile/indestructable,
/turf/open/floor/plating/dirt/jungle/wasteland,
/area/city/backstreets_room)
"OW" = (
/obj/structure/bookcase/random/nonfiction,
/turf/closed/indestructible/wood,
/area/city/backstreets_room)
"OZ" = (
/obj/item/flashlight/spotlight,
/obj/effect/turf_decal/siding/wood/corner{
	dir = 1
	},
/turf/open/indestructible/hotelwood,
/area/city/backstreets_room)
"Pf" = (
/obj/structure/table/wood,
/obj/item/book/random{
	pixel_x = -3
	},
/turf/open/indestructible/hotelwood,
/area/city/backstreets_room)
"Qo" = (
/obj/item/book/random,
/obj/item/book/random{
	pixel_y = 2
	},
/obj/item/book/random{
	pixel_y = 2;
	pixel_x = 7
	},
/obj/item/book/random{
	pixel_x = -5
	},
/obj/item/book/random{
	pixel_x = 7
	},
/obj/item/flashlight/spotlight,
/obj/effect/turf_decal/siding/wood,
/turf/open/indestructible/hotelwood,
/area/city/backstreets_room)
"Qs" = (
/obj/effect/turf_decal/siding/wood,
/obj/item/flashlight/spotlight,
/turf/open/indestructible/hotelwood,
/area/city/backstreets_room)
"RS" = (
/obj/structure/table/wood,
/obj/item/book/random,
/turf/open/indestructible/hotelwood,
/area/city/backstreets_room)
"Su" = (
/turf/open/indestructible/hotelwood,
/area/city/backstreets_room)
"Sx" = (
/obj/item/book/random,
/obj/item/book/random{
	pixel_y = 2
	},
/obj/item/book/random{
	pixel_y = 2;
	pixel_x = 7
	},
/obj/item/book/random{
	pixel_x = -5
	},
/obj/item/book/random{
	pixel_x = 7
	},
/obj/structure/table/wood,
/turf/open/indestructible/hotelwood,
/area/city/backstreets_room)
"Sy" = (
/obj/effect/turf_decal/siding/wood{
	dir = 4
	},
/obj/effect/turf_decal/siding/wood/corner{
	dir = 4
	},
/obj/structure/fireplace,
/turf/open/indestructible/hotelwood,
/area/city/backstreets_room)
"SX" = (
/obj/effect/turf_decal/siding/wood{
	dir = 8
	},
/obj/effect/turf_decal/siding/wood{
	dir = 4
	},
/turf/open/indestructible/hotelwood,
/area/city/backstreets_room)
"Tf" = (
/obj/effect/turf_decal/trimline/purple/filled/line{
	dir = 6
	},
/turf/open/floor/pod/dark,
/area/city/backstreets_room)
"TX" = (
/obj/effect/decal/cleanable/blood,
/turf/open/floor/wood,
/area/city/backstreets_room)
"Uw" = (
/obj/item/flashlight/spotlight,
/obj/effect/turf_decal/siding/wood,
/turf/open/indestructible/hotelwood,
/area/city/backstreets_room)
"Vp" = (
/obj/structure/chair/wood{
	dir = 4
	},
/turf/open/indestructible/hotelwood,
/area/city/backstreets_room)
"WC" = (
/obj/effect/turf_decal/siding/wood/corner{
	dir = 2
	},
/turf/open/indestructible/hotelwood,
/area/city/backstreets_room)
"Xn" = (
/obj/effect/turf_decal/siding/wood,
/turf/open/indestructible/hotelwood,
/area/city/backstreets_room)
"XO" = (
/obj/structure/table/wood,
/obj/item/toy/plush/scorched,
/obj/effect/turf_decal/siding/wood/corner{
	dir = 8
	},
/turf/open/indestructible/hotelwood,
/area/city/backstreets_room)
"Yn" = (
/obj/effect/turf_decal/trimline/purple/filled/line{
	dir = 10
	},
/obj/item/flashlight/spotlight,
/turf/open/floor/pod/dark,
/area/city/backstreets_room)
"YI" = (
/obj/item/flashlight/spotlight,
/obj/effect/turf_decal/siding/wood/corner{
	dir = 1
	},
/obj/structure/fireplace,
/turf/open/indestructible/hotelwood,
/area/city/backstreets_room)
"Zg" = (
/obj/structure/bookcase/random/nonfiction,
/turf/open/indestructible/hotelwood,
/area/city/backstreets_room)
"ZB" = (
/obj/effect/decal/cleanable/blood/footprints,
/turf/open/floor/wood,
/area/city/backstreets_room)
"ZW" = (
/obj/structure/table/wood,
/obj/item/gun/ego_gun/city/thumb/weak,
/obj/item/toy/plush/netzach,
/obj/item/reagent_containers/food/drinks/beer{
	pixel_x = -9
	},
/obj/item/reagent_containers/food/drinks/beer{
	pixel_x = 11;
	pixel_y = -9
	},
/turf/open/floor/plating/dirt/jungle/wasteland,
/area/city/backstreets_room)

(1,1,1) = {"
xi
xi
xi
xi
xi
xi
xi
xi
dI
dI
dI
dI
dI
dI
dI
dI
dI
dI
dI
dI
xi
xi
xi
xi
"}
(2,1,1) = {"
xi
xi
xi
xi
xi
xi
xi
xi
dI
Zg
In
Su
RS
mP
Su
mP
RS
Xn
Zg
dI
xi
xi
xi
xi
"}
(3,1,1) = {"
xi
xi
xi
xi
xi
xi
xi
xi
dI
re
JZ
Su
NZ
NZ
Su
NZ
NZ
AC
re
dI
xi
xi
xi
xi
"}
(4,1,1) = {"
xi
xi
xi
xi
xi
xi
xi
xi
dI
Sy
wV
WC
Ht
Ht
yk
Ht
Ht
yk
Ht
dI
xi
xi
xi
xi
"}
(5,1,1) = {"
xi
xi
xi
xi
xi
xi
xi
xi
dI
aL
In
Xn
Zg
aL
IW
Zg
Zg
cT
Zg
dI
xi
xi
xi
xi
"}
(6,1,1) = {"
xi
xi
xi
xi
xi
xi
xi
xi
dI
Zg
In
Xn
Zg
Zg
IW
Zg
Zg
Hx
Zg
dI
xi
xi
xi
xi
"}
(7,1,1) = {"
xi
xi
xi
xi
xi
xi
xi
xi
dI
so
JZ
AC
re
re
tO
re
re
tO
re
dI
xi
xi
xi
xi
"}
(8,1,1) = {"
xi
xi
xi
xi
xi
xi
xi
xi
dI
Ht
wV
WC
Ht
Ht
yk
Ht
Ht
yk
Ht
dI
xi
xi
xi
xi
"}
(9,1,1) = {"
xi
xi
xi
xi
xi
xi
xi
xi
dI
Zg
In
Xn
aL
Zg
IW
Zg
aL
IW
Zg
dI
xi
xi
xi
xi
"}
(10,1,1) = {"
xi
xi
xi
xi
dI
dI
dI
dI
dI
dI
dI
cf
dI
dI
dI
dI
dI
cf
dI
dI
dI
dI
dI
dI
"}
(11,1,1) = {"
xi
xi
xi
xi
OW
In
Xn
Su
Su
Xn
Su
Su
Xn
Su
Su
Xn
Su
Su
Xn
Su
Su
Xn
Xn
OW
"}
(12,1,1) = {"
xi
xi
xi
xi
OW
In
Xn
Su
Su
Xn
Su
Su
Xn
Su
Su
Xn
Su
Su
Xn
Su
Su
Xn
Xn
OW
"}
(13,1,1) = {"
Cn
Cn
Cn
Cn
dI
cH
Xn
Su
cH
Xn
Su
Su
Qs
Su
pT
Xn
cH
Su
Xn
Su
cH
Xn
Su
dI
"}
(14,1,1) = {"
Cn
jS
Yn
Cn
dI
nt
Xn
Su
Su
Xn
Su
Su
Xn
Su
Su
Xn
Su
Su
Xn
Su
Su
Xn
Su
dI
"}
(15,1,1) = {"
Cn
FT
FS
iK
eH
In
Xn
Su
pT
Xn
Su
Su
Xn
Su
Su
Xn
Su
Su
zK
Su
pT
Xn
Su
dI
"}
(16,1,1) = {"
Cn
IZ
LU
zT
eH
In
Xn
Su
Su
Xn
Su
Su
Xn
Su
Su
Xn
Su
Su
Xn
Su
Su
Xn
Su
dI
"}
(17,1,1) = {"
Cn
vm
nX
Tf
eH
In
Xn
Su
Su
Xn
Su
Su
Xn
Su
Su
Xn
Su
Su
Xn
Su
Su
Xn
Su
dI
"}
(18,1,1) = {"
Cn
nu
tK
Cn
dI
YI
Xn
Su
cH
Xn
Su
pT
Qs
Su
Su
Xn
cH
Su
Xn
Su
cH
Xn
Su
dI
"}
(19,1,1) = {"
Cn
Cn
Cn
Cn
dI
Su
Xn
Su
Su
Xn
Su
Su
Xn
Su
Su
Xn
Su
pT
Xn
Su
Su
Xn
pT
dI
"}
(20,1,1) = {"
xi
xi
xi
xi
dI
Su
Xn
Su
Su
Xn
Su
Su
Xn
Su
Su
Xn
Su
Su
Xn
Su
Su
Xn
Su
dI
"}
(21,1,1) = {"
xi
xi
xi
xi
dI
pT
Xn
Su
Su
Xn
Su
Su
Xn
Su
Su
Xn
Su
Su
Xn
Su
Su
Xn
Su
dI
"}
(22,1,1) = {"
xi
xi
xi
xi
dI
Su
Xn
Su
Su
Xn
Su
Su
Xn
Su
Su
Xn
Su
Su
Xn
Su
Su
Xn
Su
dI
"}
(23,1,1) = {"
xi
xi
xi
xi
dI
cH
Xn
Su
cH
Xn
Su
pT
Qs
Su
Su
Xn
cH
Su
Xn
Su
cH
Xn
Su
dI
"}
(24,1,1) = {"
xi
xi
xi
xi
dI
Su
Xn
Su
Su
Xn
Su
Su
zK
Su
Su
Xn
Su
pT
Xn
Su
Su
Xn
Su
dI
"}
(25,1,1) = {"
xi
xi
xi
xi
dI
Su
Xn
Su
Su
Xn
Su
Su
Xn
Su
Su
Xn
Su
Su
Xn
Su
Su
Xn
Su
dI
"}
(26,1,1) = {"
dI
dI
dI
dI
dI
wV
Xn
Su
Su
Xn
Su
Su
Xn
Su
Su
Xn
Su
Su
Xn
Su
Su
Xn
Su
dI
"}
(27,1,1) = {"
dG
TX
Lx
dI
dI
AA
Xn
Su
pT
Xn
Su
Su
Xn
Su
pT
Xn
Su
Su
Xn
Su
pT
Xn
Su
dI
"}
(28,1,1) = {"
dG
fP
aN
TX
xg
li
Xn
Su
cH
Xn
Su
Su
Qs
Su
Su
Xn
cH
Su
Xn
Su
cH
Xn
Su
dI
"}
(29,1,1) = {"
dI
vT
ai
pL
xg
In
Xn
Su
Su
Xn
Su
Su
Xn
Su
Su
Xn
Su
Su
Xn
Su
Su
Xn
Su
dI
"}
(30,1,1) = {"
dI
mv
gc
Fc
xg
In
Xn
Su
Su
Xn
Su
Su
Xn
Su
Su
Xn
Su
Su
Xn
Su
Su
Xn
Su
dI
"}
(31,1,1) = {"
dG
Jz
ZB
uv
xg
In
Xn
Su
Su
Xn
Su
Su
Xn
Su
Su
Xn
Su
pT
Xn
Su
Su
Xn
Su
dI
"}
(32,1,1) = {"
dG
TX
Lx
dI
dI
AA
Xn
Su
Su
Xn
Su
Su
Xn
Su
Su
Xn
Su
Su
Xn
Su
Su
Xn
Su
dI
"}
(33,1,1) = {"
dI
dI
dI
dI
dI
OZ
Xn
Su
cH
Xn
Su
pT
Qs
Su
Su
Xn
cH
Su
Xn
Su
cH
Xn
Su
dI
"}
(34,1,1) = {"
xi
xi
xi
xi
dI
Su
Xn
Su
Su
Xn
Su
Su
Xn
Su
Su
Xn
Su
Su
Xn
Su
Su
Xn
Su
dI
"}
(35,1,1) = {"
xi
xi
xi
xi
dI
Su
Xn
Su
pT
Xn
Su
Su
Xn
Su
Su
Xn
Su
Su
Xn
Su
Su
Xn
Su
dI
"}
(36,1,1) = {"
xi
xi
xi
xi
dI
Su
Xn
Su
Su
Xn
Su
Su
Xn
Su
Su
Xn
Su
Su
Xn
Su
pT
Xn
Su
dI
"}
(37,1,1) = {"
xi
xi
xi
xi
dI
pT
Xn
Su
Su
Xn
Su
Su
Xn
Su
Su
Xn
Su
Su
Xn
Su
Su
Xn
pT
dI
"}
(38,1,1) = {"
xi
xi
xi
xi
dI
cH
Xn
Su
cH
Xn
Su
Su
Qs
Su
Su
Xn
cH
pT
Xn
Su
cH
Xn
Su
dI
"}
(39,1,1) = {"
xi
xi
xi
xi
dI
Su
Xn
Su
Su
Xn
Su
Su
Xn
Su
Su
Xn
Su
Su
Xn
Su
Su
Xn
Su
dI
"}
(40,1,1) = {"
bK
bK
bK
bK
dI
Su
Xn
Su
pT
Xn
Su
Su
Xn
Su
Su
Xn
Su
Su
Xn
Su
Su
Xn
Su
dI
"}
(41,1,1) = {"
bK
Cx
ct
bK
dI
Ai
Xn
Su
Su
Xn
Su
pT
Xn
Su
Su
Xn
Su
Su
Xn
Su
Su
Xn
Su
dI
"}
(42,1,1) = {"
bK
av
ui
to
Oy
wV
Xn
Su
Su
Xn
Su
Su
Xn
Su
Su
Xn
Su
Su
Xn
Su
pT
Xn
Su
dI
"}
(43,1,1) = {"
bK
IM
jI
kN
Oy
li
Xn
Su
cH
Xn
Su
Su
Qs
Su
Su
Xn
cH
Su
Xn
Su
cH
Xn
Su
dI
"}
(44,1,1) = {"
bK
ZW
jq
Lk
Oy
In
Xn
Su
pT
Xn
Su
Su
Xn
Su
Su
Xn
Su
Su
Xn
Su
Su
Xn
Su
dI
"}
(45,1,1) = {"
bK
Lk
eV
bK
dI
AA
zK
Su
Su
Xn
Su
Su
Xn
Su
pT
Xn
Su
pT
Xn
Su
Su
Xn
Su
dI
"}
(46,1,1) = {"
bK
bK
bK
bK
dI
JZ
Xn
Su
Su
Xn
Su
pT
Xn
Su
Su
Xn
Su
Su
Xn
Su
Su
Xn
Su
dI
"}
(47,1,1) = {"
xi
xi
xi
xi
OW
hL
Xn
Su
Su
Xn
Su
Su
Xn
Su
Su
Xn
Su
Su
Xn
Su
Su
Xn
Xn
OW
"}
(48,1,1) = {"
xi
xi
xi
xi
OW
sN
Xn
Su
cH
Xn
Su
Su
Qs
Su
Su
Xn
cH
Su
Xn
Su
cH
Xn
Xn
OW
"}
(49,1,1) = {"
xi
xi
xi
xi
dI
dI
dI
dI
dI
dI
dI
cf
dI
dI
dI
dI
dI
cf
dI
dI
dI
dI
dI
dI
"}
(50,1,1) = {"
xi
xi
xi
xi
xi
xi
xi
xi
dI
uN
Su
Su
Vp
Vp
Su
Vp
Vp
Su
Sx
dI
xi
xi
xi
xi
"}
(51,1,1) = {"
xi
xi
xi
xi
xi
xi
xi
xi
dI
wV
Su
Su
Pf
mP
Su
mP
pJ
Su
WC
dI
xi
xi
xi
xi
"}
(52,1,1) = {"
xi
xi
xi
xi
xi
xi
xi
xi
OW
In
Su
Su
NZ
NZ
Su
NZ
NZ
Su
Xn
OW
xi
xi
xi
xi
"}
(53,1,1) = {"
xi
xi
xi
xi
xi
xi
xi
xi
OW
In
Su
WC
KL
Ht
Ht
KL
Ht
wV
Qo
OW
xi
xi
xi
xi
"}
(54,1,1) = {"
xi
xi
xi
xi
xi
xi
xi
xi
dI
Il
Su
Xn
Zg
Zg
Zg
Zg
Zg
In
AC
dI
xi
xi
xi
xi
"}
(55,1,1) = {"
xi
xi
xi
xi
xi
xi
xi
xi
dI
Sx
Su
gg
SX
SX
SX
SX
SX
yW
Su
dI
xi
xi
xi
xi
"}
(56,1,1) = {"
xi
xi
xi
xi
xi
xi
xi
xi
dI
nt
Su
Xn
Zg
Zg
Zg
Zg
Zg
In
WC
dI
xi
xi
xi
xi
"}
(57,1,1) = {"
xi
xi
xi
xi
xi
xi
xi
xi
OW
In
Su
AC
xW
re
re
xW
re
JZ
Uw
OW
xi
xi
xi
xi
"}
(58,1,1) = {"
xi
xi
xi
xi
xi
xi
xi
xi
OW
Cs
Su
Vp
Su
Su
Su
Su
Su
Vp
CM
OW
xi
xi
xi
xi
"}
(59,1,1) = {"
xi
xi
xi
xi
xi
xi
xi
xi
dI
ky
Su
jc
Ht
wV
eB
EY
Ht
bf
XO
dI
xi
xi
xi
xi
"}
(60,1,1) = {"
xi
xi
xi
xi
xi
xi
xi
xi
dI
dI
dI
dI
OW
dI
dI
dI
OW
dI
dI
dI
xi
xi
xi
xi
"}
