//MAP CONVERTED BY dmm2tgm.py THIS HEADER COMMENT PREVENTS RECONVERSION, DO NOT REMOVE
"a" = (
/turf/open/space/basic,
/area/space)
"q" = (
/turf/closed/indestructible/syndicate,
/area/space)

(1,1,1) = {"
a
a
a
a
a
a
a
q
q
q
q
q
q
q
q
q
q
q
q
a
a
a
a
a
"}
(2,1,1) = {"
a
a
a
a
a
a
a
q
a
a
a
a
a
a
a
a
a
a
q
a
a
a
a
a
"}
(3,1,1) = {"
a
a
a
a
a
a
a
q
a
a
a
a
a
a
a
a
a
a
q
a
a
a
a
a
"}
(4,1,1) = {"
a
a
a
a
a
a
a
q
a
a
a
a
a
a
a
a
a
a
q
a
a
a
a
a
"}
(5,1,1) = {"
a
a
a
a
a
a
a
q
a
a
a
a
a
a
a
a
a
a
q
a
a
a
a
a
"}
(6,1,1) = {"
a
a
a
a
a
a
a
q
a
a
a
a
a
a
a
a
a
a
q
a
a
a
a
a
"}
(7,1,1) = {"
a
a
a
a
a
a
a
q
a
a
a
a
a
a
a
a
a
a
q
a
a
a
a
a
"}
(8,1,1) = {"
a
a
a
a
a
a
a
q
a
a
a
a
a
a
a
a
a
a
q
a
a
a
a
a
"}
(9,1,1) = {"
a
a
a
a
a
a
a
q
a
a
a
a
a
a
a
a
a
a
q
a
a
a
a
a
"}
(10,1,1) = {"
a
a
a
q
q
q
q
q
q
q
q
q
q
q
q
q
q
q
q
q
q
q
q
a
"}
(11,1,1) = {"
a
a
a
q
a
a
a
a
a
a
a
a
a
a
a
a
a
a
a
a
a
a
q
a
"}
(12,1,1) = {"
a
a
a
q
a
a
a
a
a
a
a
a
a
a
a
a
a
a
a
a
a
a
q
a
"}
(13,1,1) = {"
a
a
a
q
a
a
a
a
a
a
a
a
a
a
a
a
a
a
a
a
a
a
q
a
"}
(14,1,1) = {"
a
a
a
q
a
a
a
a
a
a
a
a
a
a
a
a
a
a
a
a
a
a
q
a
"}
(15,1,1) = {"
a
a
a
q
a
a
a
a
a
a
a
a
a
a
a
a
a
a
a
a
a
a
q
a
"}
(16,1,1) = {"
a
a
a
q
a
a
a
a
a
a
a
a
a
a
a
a
a
a
a
a
a
a
q
a
"}
(17,1,1) = {"
a
a
a
q
a
a
a
a
a
a
a
a
a
a
a
a
a
a
a
a
a
a
q
a
"}
(18,1,1) = {"
a
a
a
q
a
a
a
a
a
a
a
a
a
a
a
a
a
a
a
a
a
a
q
a
"}
(19,1,1) = {"
a
a
a
q
a
a
a
a
a
a
a
a
a
a
a
a
a
a
a
a
a
a
q
a
"}
(20,1,1) = {"
a
a
a
q
a
a
a
a
a
a
a
a
a
a
a
a
a
a
a
a
a
a
q
a
"}
(21,1,1) = {"
a
a
a
q
a
a
a
a
a
a
a
a
a
a
a
a
a
a
a
a
a
a
q
a
"}
(22,1,1) = {"
a
a
a
q
a
a
a
a
a
a
a
a
a
a
a
a
a
a
a
a
a
a
q
a
"}
(23,1,1) = {"
a
a
a
q
a
a
a
a
a
a
a
a
a
a
a
a
a
a
a
a
a
a
q
a
"}
(24,1,1) = {"
a
a
a
q
a
a
a
a
a
a
a
a
a
a
a
a
a
a
a
a
a
a
q
a
"}
(25,1,1) = {"
a
a
a
q
a
a
a
a
a
a
a
a
a
a
a
a
a
a
a
a
a
a
q
a
"}
(26,1,1) = {"
a
a
a
q
a
a
a
a
a
a
a
a
a
a
a
a
a
a
a
a
a
a
q
a
"}
(27,1,1) = {"
a
a
a
q
a
a
a
a
a
a
a
a
a
a
a
a
a
a
a
a
a
a
q
a
"}
(28,1,1) = {"
a
a
a
q
a
a
a
a
a
a
a
a
a
a
a
a
a
a
a
a
a
a
q
a
"}
(29,1,1) = {"
a
a
a
q
a
a
a
a
a
a
a
a
a
a
a
a
a
a
a
a
a
a
q
a
"}
(30,1,1) = {"
a
a
a
q
a
a
a
a
a
a
a
a
a
a
a
a
a
a
a
a
a
a
q
a
"}
(31,1,1) = {"
a
a
a
q
a
a
a
a
a
a
a
a
a
a
a
a
a
a
a
a
a
a
q
a
"}
(32,1,1) = {"
a
a
a
q
a
a
a
a
a
a
a
a
a
a
a
a
a
a
a
a
a
a
q
a
"}
(33,1,1) = {"
a
a
a
q
a
a
a
a
a
a
a
a
a
a
a
a
a
a
a
a
a
a
q
a
"}
(34,1,1) = {"
a
a
a
q
a
a
a
a
a
a
a
a
a
a
a
a
a
a
a
a
a
a
q
a
"}
(35,1,1) = {"
a
a
a
q
a
a
a
a
a
a
a
a
a
a
a
a
a
a
a
a
a
a
q
a
"}
(36,1,1) = {"
a
a
a
q
a
a
a
a
a
a
a
a
a
a
a
a
a
a
a
a
a
a
q
a
"}
(37,1,1) = {"
a
a
a
q
a
a
a
a
a
a
a
a
a
a
a
a
a
a
a
a
a
a
q
a
"}
(38,1,1) = {"
a
a
a
q
a
a
a
a
a
a
a
a
a
a
a
a
a
a
a
a
a
a
q
a
"}
(39,1,1) = {"
a
a
a
q
a
a
a
a
a
a
a
a
a
a
a
a
a
a
a
a
a
a
q
a
"}
(40,1,1) = {"
a
a
a
q
a
a
a
a
a
a
a
a
a
a
a
a
a
a
a
a
a
a
q
a
"}
(41,1,1) = {"
a
a
a
q
a
a
a
a
a
a
a
a
a
a
a
a
a
a
a
a
a
a
q
a
"}
(42,1,1) = {"
a
a
a
q
a
a
a
a
a
a
a
a
a
a
a
a
a
a
a
a
a
a
q
a
"}
(43,1,1) = {"
a
a
a
q
a
a
a
a
a
a
a
a
a
a
a
a
a
a
a
a
a
a
q
a
"}
(44,1,1) = {"
a
a
a
q
a
a
a
a
a
a
a
a
a
a
a
a
a
a
a
a
a
a
q
a
"}
(45,1,1) = {"
a
a
a
q
a
a
a
a
a
a
a
a
a
a
a
a
a
a
a
a
a
a
q
a
"}
(46,1,1) = {"
a
a
a
q
a
a
a
a
a
a
a
a
a
a
a
a
a
a
a
a
a
a
q
a
"}
(47,1,1) = {"
a
a
a
q
a
a
a
a
a
a
a
a
a
a
a
a
a
a
a
a
a
a
q
a
"}
(48,1,1) = {"
a
a
a
q
a
a
a
a
a
a
a
a
a
a
a
a
a
a
a
a
a
a
q
a
"}
(49,1,1) = {"
a
a
a
q
q
q
q
q
q
q
q
q
q
q
q
q
q
q
q
q
q
q
q
a
"}
(50,1,1) = {"
a
a
a
a
a
a
a
q
a
a
a
a
a
a
a
a
a
a
q
a
a
a
a
a
"}
(51,1,1) = {"
a
a
a
a
a
a
a
q
a
a
a
a
a
a
a
a
a
a
q
a
a
a
a
a
"}
(52,1,1) = {"
a
a
a
a
a
a
a
q
a
a
a
a
a
a
a
a
a
a
q
a
a
a
a
a
"}
(53,1,1) = {"
a
a
a
a
a
a
a
q
a
a
a
a
a
a
a
a
a
a
q
a
a
a
a
a
"}
(54,1,1) = {"
a
a
a
a
a
a
a
q
a
a
a
a
a
a
a
a
a
a
q
a
a
a
a
a
"}
(55,1,1) = {"
a
a
a
a
a
a
a
q
a
a
a
a
a
a
a
a
a
a
q
a
a
a
a
a
"}
(56,1,1) = {"
a
a
a
a
a
a
a
q
a
a
a
a
a
a
a
a
a
a
q
a
a
a
a
a
"}
(57,1,1) = {"
a
a
a
a
a
a
a
q
a
a
a
a
a
a
a
a
a
a
q
a
a
a
a
a
"}
(58,1,1) = {"
a
a
a
a
a
a
a
q
a
a
a
a
a
a
a
a
a
a
q
a
a
a
a
a
"}
(59,1,1) = {"
a
a
a
a
a
a
a
q
a
a
a
a
a
a
a
a
a
a
q
a
a
a
a
a
"}
(60,1,1) = {"
a
a
a
a
a
a
a
q
q
q
q
q
q
q
q
q
q
q
q
a
a
a
a
a
"}
