//MAP CONVERTED BY dmm2tgm.py THIS HEADER COMMENT PREVENTS RECONVERSION, DO NOT REMOVE
"aq" = (
/obj/item/toy/plush/yesod,
/obj/item/gun/ego_gun/pistol/solemnlament{
	pixel_x = -20;
	pixel_y = 0
	},
/obj/item/gun/ego_gun/pistol/solemnvow{
	pixel_y = 0;
	pixel_x = 18
	},
/obj/effect/turf_decal/trimline/purple/filled/line,
/turf/open/floor/pod/dark,
/area/library_floors/floor_techsci)
"aB" = (
/obj/effect/light_emitter{
	light_power = 4;
	light_range = 30;
	set_cap = 3;
	set_luminosity = 24
	},
/turf/open/floor/pod/dark,
/area/library_floors/floor_techsci)
"aH" = (
/obj/structure/window/reinforced/fulltile/indestructable,
/turf/open/floor/pod/dark,
/area/library_floors/floor_techsci)
"bi" = (
/turf/open/floor/plating/ashplanet,
/area/library_floors/floor_techsci)
"bF" = (
/obj/effect/turf_decal/trimline/purple/filled/line{
	dir = 8
	},
/turf/open/floor/pod/dark,
/area/library_floors/floor_techsci)
"cU" = (
/obj/effect/decal/cleanable/robot_debris/old,
/turf/open/floor/plating/ashplanet,
/area/library_floors/floor_techsci)
"dI" = (
/obj/structure/railing{
	name = "invincible railing";
	resistance_flags = 64
	},
/obj/effect/decal/cleanable/dirt,
/obj/effect/turf_decal/trimline/purple/filled/line,
/turf/open/floor/pod/light,
/area/library_floors/floor_techsci)
"eJ" = (
/obj/effect/turf_decal/trimline/purple/filled/line{
	dir = 8
	},
/obj/structure/bookcase/random/nonfiction,
/turf/open/floor/pod/dark,
/area/library_floors/floor_techsci)
"eN" = (
/obj/structure/table/reinforced,
/turf/open/floor/pod/dark,
/area/library_floors/floor_techsci)
"fW" = (
/obj/effect/turf_decal/trimline/yellow/filled/line{
	dir = 1
	},
/turf/open/floor/plating/ashplanet,
/area/library_floors/floor_techsci)
"go" = (
/obj/effect/turf_decal/trimline/purple/filled/line,
/obj/effect/light_emitter{
	light_power = 4;
	light_range = 30;
	set_cap = 3;
	set_luminosity = 24
	},
/turf/open/floor/pod/dark,
/area/library_floors/floor_techsci)
"gG" = (
/obj/structure/mecha_wreckage/durand,
/obj/effect/turf_decal/trimline/purple/filled/line{
	dir = 9
	},
/turf/open/floor/pod/dark,
/area/library_floors/floor_techsci)
"gN" = (
/obj/effect/turf_decal/trimline/purple/filled/line{
	dir = 1
	},
/turf/open/floor/pod/dark,
/area/library_floors/floor_techsci)
"iz" = (
/obj/structure/chair/greyscale{
	dir = 4
	},
/obj/effect/turf_decal/trimline/purple/filled/line{
	dir = 4
	},
/turf/open/floor/pod/dark,
/area/library_floors/floor_techsci)
"iM" = (
/obj/structure/table/reinforced,
/obj/item/reagent_containers/food/drinks/coffee,
/turf/open/floor/pod/dark,
/area/library_floors/floor_techsci)
"js" = (
/obj/effect/turf_decal/trimline/purple/filled/line{
	dir = 5
	},
/turf/open/floor/pod/dark,
/area/library_floors/floor_techsci)
"kk" = (
/obj/effect/turf_decal/trimline/purple/filled/line{
	dir = 6
	},
/turf/open/floor/pod/dark,
/area/library_floors/floor_techsci)
"lg" = (
/obj/effect/decal/cleanable/robot_debris/general_scrap,
/turf/open/floor/plating/ashplanet,
/area/library_floors/floor_techsci)
"mH" = (
/obj/structure/railing{
	name = "invincible railing";
	resistance_flags = 64
	},
/obj/effect/turf_decal/trimline/purple/filled/line{
	dir = 10
	},
/turf/open/floor/pod/light,
/area/library_floors/floor_techsci)
"mN" = (
/obj/effect/turf_decal/trimline/purple/filled/line{
	dir = 1
	},
/obj/effect/turf_decal/trimline/purple/filled/corner{
	dir = 8
	},
/turf/open/floor/pod/dark,
/area/library_floors/floor_techsci)
"nJ" = (
/obj/structure/railing{
	name = "invincible railing";
	resistance_flags = 64
	},
/obj/effect/turf_decal/trimline/purple/filled/line{
	dir = 6
	},
/turf/open/floor/pod/light,
/area/library_floors/floor_techsci)
"or" = (
/obj/machinery/door/airlock/hatch,
/turf/open/floor/pod/dark,
/area/library_floors/floor_techsci)
"qa" = (
/obj/effect/turf_decal/trimline/purple/filled/line{
	dir = 1
	},
/obj/effect/turf_decal/trimline/purple/filled/line,
/turf/open/floor/pod/dark,
/area/library_floors/floor_techsci)
"rK" = (
/obj/effect/decal/cleanable/glass,
/turf/open/floor/plating/ashplanet,
/area/library_floors/floor_techsci)
"rN" = (
/obj/structure/falsewall/plastitanium,
/turf/open/floor/pod/dark,
/area/library_floors/floor_techsci)
"rY" = (
/obj/structure/railing{
	name = "invincible railing";
	resistance_flags = 64
	},
/obj/effect/turf_decal/trimline/purple/filled/line,
/turf/open/floor/pod/light,
/area/library_floors/floor_techsci)
"sm" = (
/obj/item/light/bulb/broken,
/turf/open/floor/plating/ashplanet,
/area/library_floors/floor_techsci)
"sF" = (
/obj/structure/table/reinforced,
/obj/item/storage/fancy/donut_box,
/turf/open/floor/pod/dark,
/area/library_floors/floor_techsci)
"ty" = (
/obj/structure/table/reinforced,
/obj/item/book/random,
/turf/open/floor/pod/dark,
/area/library_floors/floor_techsci)
"wX" = (
/obj/machinery/shuttle_manipulator{
	desc = "A holographic display of the cruise shuttle we're on right now.";
	layer = 2.7;
	max_integrity = 99999;
	name = "shuttle holographic display"
	},
/turf/open/floor/pod/dark,
/area/library_floors/floor_techsci)
"xo" = (
/obj/effect/turf_decal/trimline/purple/filled/line{
	dir = 1
	},
/obj/structure/bookcase/random/nonfiction,
/turf/open/floor/pod/dark,
/area/library_floors/floor_techsci)
"yO" = (
/obj/effect/turf_decal/trimline/purple/filled/corner{
	dir = 1
	},
/turf/open/floor/pod/dark,
/area/library_floors/floor_techsci)
"zb" = (
/obj/structure/railing{
	name = "invincible railing";
	resistance_flags = 64
	},
/obj/effect/turf_decal/trimline/purple/filled/line,
/obj/structure/fluff/big_chain{
	pixel_y = 12
	},
/turf/open/floor/pod/light,
/area/library_floors/floor_techsci)
"Am" = (
/obj/effect/turf_decal/trimline/yellow/filled/line{
	dir = 1
	},
/obj/structure/mecha_wreckage,
/turf/open/floor/plating/ashplanet,
/area/library_floors/floor_techsci)
"BF" = (
/obj/structure/falsewall/plastitanium,
/turf/open/space/basic,
/area/library_floors/floor_techsci)
"BN" = (
/obj/effect/turf_decal/trimline/purple/filled/line{
	dir = 1
	},
/obj/effect/turf_decal/trimline/purple/filled/corner,
/turf/open/floor/pod/dark,
/area/library_floors/floor_techsci)
"BR" = (
/obj/effect/turf_decal/trimline/purple/filled/line{
	dir = 6
	},
/obj/structure/bookcase/random/nonfiction,
/turf/open/floor/pod/dark,
/area/library_floors/floor_techsci)
"Ck" = (
/obj/structure/bookcase/random/nonfiction,
/turf/open/floor/pod/dark,
/area/library_floors/floor_techsci)
"Cl" = (
/obj/structure/railing{
	name = "invincible railing";
	resistance_flags = 64;
	dir = 1
	},
/obj/effect/decal/cleanable/dirt,
/obj/effect/turf_decal/trimline/purple/filled/line{
	dir = 1
	},
/turf/open/floor/pod/light,
/area/library_floors/floor_techsci)
"Cq" = (
/obj/effect/turf_decal/trimline/white/filled/line{
	pixel_y = 10
	},
/obj/effect/decal/cleanable/glass,
/turf/open/floor/plating/ashplanet,
/area/library_floors/floor_techsci)
"Cu" = (
/turf/open/floor/pod/dark,
/area/library_floors/floor_techsci)
"Db" = (
/obj/structure/chair/greyscale{
	dir = 8
	},
/obj/effect/turf_decal/trimline/purple/filled/line{
	dir = 8
	},
/turf/open/floor/pod/dark,
/area/library_floors/floor_techsci)
"Ep" = (
/obj/effect/turf_decal/trimline/purple/filled/line{
	dir = 4
	},
/turf/open/floor/pod/dark,
/area/library_floors/floor_techsci)
"EZ" = (
/obj/effect/turf_decal/trimline/purple/filled/line{
	dir = 9
	},
/obj/structure/bookcase/random/nonfiction,
/turf/open/floor/pod/dark,
/area/library_floors/floor_techsci)
"Fg" = (
/obj/effect/turf_decal/trimline/purple/filled/line{
	dir = 9
	},
/turf/open/floor/pod/dark,
/area/library_floors/floor_techsci)
"FY" = (
/obj/structure/railing{
	name = "invincible railing";
	resistance_flags = 64;
	dir = 1
	},
/obj/effect/turf_decal/trimline/purple/filled/line{
	dir = 5
	},
/turf/open/floor/pod/light,
/area/library_floors/floor_techsci)
"Gu" = (
/obj/structure/falsewall/plastitanium,
/obj/item/wallframe/newscaster,
/turf/open/space/basic,
/area/library_floors/floor_techsci)
"Hg" = (
/obj/item/toy/plush/myo,
/obj/effect/turf_decal/trimline/purple/filled/line{
	dir = 10
	},
/turf/open/floor/pod/dark,
/area/library_floors/floor_techsci)
"Hk" = (
/turf/open/space/basic,
/area/space)
"HW" = (
/obj/effect/turf_decal/trimline/purple/filled/corner{
	dir = 4
	},
/turf/open/floor/pod/dark,
/area/library_floors/floor_techsci)
"Iy" = (
/obj/effect/turf_decal/trimline/purple/filled/line{
	dir = 8
	},
/obj/effect/turf_decal/trimline/purple/filled/corner,
/turf/open/floor/pod/dark,
/area/library_floors/floor_techsci)
"JL" = (
/obj/effect/turf_decal/trimline/yellow/filled/line,
/obj/effect/decal/cleanable/robot_debris/limb,
/obj/effect/decal/cleanable/robot_debris/old,
/turf/open/floor/plating/ashplanet,
/area/library_floors/floor_techsci)
"Kd" = (
/obj/effect/turf_decal/trimline/purple/filled/line{
	dir = 5
	},
/obj/structure/bookcase/random/nonfiction,
/turf/open/floor/pod/dark,
/area/library_floors/floor_techsci)
"Ki" = (
/obj/structure/railing{
	name = "invincible railing";
	resistance_flags = 64
	},
/obj/effect/turf_decal/trimline/purple/filled/line,
/obj/structure/fluff/big_chain{
	pixel_y = 11
	},
/turf/open/floor/pod/light,
/area/library_floors/floor_techsci)
"Ks" = (
/obj/effect/light_emitter{
	light_power = 4;
	light_range = 30;
	set_cap = 3;
	set_luminosity = 24
	},
/turf/open/floor/fakepit{
	density = 1
	},
/area/library_floors/floor_techsci)
"Kt" = (
/obj/effect/turf_decal/trimline/yellow/filled/line,
/turf/open/floor/plating/ashplanet,
/area/library_floors/floor_techsci)
"KG" = (
/obj/effect/turf_decal/trimline/purple/filled/corner,
/turf/open/floor/pod/dark,
/area/library_floors/floor_techsci)
"KL" = (
/obj/structure/flora/rock/pile,
/turf/open/floor/plating/ashplanet,
/area/library_floors/floor_techsci)
"KX" = (
/obj/effect/turf_decal/trimline/yellow/filled/line,
/obj/effect/decal/cleanable/shreds,
/turf/open/floor/plating/ashplanet,
/area/library_floors/floor_techsci)
"Lf" = (
/obj/effect/turf_decal/trimline/purple/filled/end,
/turf/open/floor/pod/dark,
/area/library_floors/floor_techsci)
"Me" = (
/obj/structure/flora/rock/jungle,
/turf/open/floor/plating/ashplanet,
/area/library_floors/floor_techsci)
"MV" = (
/obj/effect/turf_decal/trimline/purple/filled/line,
/obj/structure/bookcase/random/nonfiction,
/turf/open/floor/pod/dark,
/area/library_floors/floor_techsci)
"Os" = (
/obj/effect/turf_decal/trimline/purple/filled/line{
	dir = 1
	},
/obj/structure/chair/greyscale,
/turf/open/floor/pod/dark,
/area/library_floors/floor_techsci)
"PB" = (
/obj/effect/turf_decal/trimline/purple/filled/corner{
	dir = 8
	},
/turf/open/floor/pod/dark,
/area/library_floors/floor_techsci)
"PY" = (
/obj/structure/chair/greyscale{
	dir = 1
	},
/obj/effect/turf_decal/trimline/purple/filled/line{
	dir = 1
	},
/turf/open/floor/pod/dark,
/area/library_floors/floor_techsci)
"Qs" = (
/obj/effect/decal/cleanable/robot_debris/limb,
/turf/open/floor/plating/ashplanet,
/area/library_floors/floor_techsci)
"RW" = (
/obj/structure/railing{
	name = "invincible railing";
	resistance_flags = 64;
	dir = 1
	},
/obj/effect/turf_decal/trimline/purple/filled/line{
	dir = 9
	},
/turf/open/floor/pod/light,
/area/library_floors/floor_techsci)
"Uk" = (
/obj/effect/turf_decal/trimline/purple/filled/line,
/turf/open/floor/pod/dark,
/area/library_floors/floor_techsci)
"Us" = (
/obj/item/toy/plush/rabbit,
/obj/effect/turf_decal/trimline/purple/filled/line{
	dir = 1
	},
/turf/open/floor/pod/dark,
/area/library_floors/floor_techsci)
"UQ" = (
/obj/effect/turf_decal/trimline/purple/filled/line{
	dir = 4
	},
/obj/structure/bookcase/random/nonfiction,
/turf/open/floor/pod/dark,
/area/library_floors/floor_techsci)
"VC" = (
/obj/structure/railing{
	name = "invincible railing";
	resistance_flags = 64;
	dir = 1
	},
/obj/effect/turf_decal/trimline/purple/filled/line{
	dir = 1
	},
/turf/open/floor/pod/light,
/area/library_floors/floor_techsci)
"Wg" = (
/obj/effect/turf_decal/trimline/yellow/filled/line,
/obj/effect/light_emitter{
	light_power = 4;
	light_range = 30;
	set_cap = 3;
	set_luminosity = 24
	},
/turf/open/floor/plating/ashplanet,
/area/library_floors/floor_techsci)
"WM" = (
/obj/structure/fluff/divine/nexus,
/turf/open/floor/pod/dark,
/area/library_floors/floor_techsci)
"WS" = (
/obj/effect/turf_decal/trimline/purple/filled/line{
	dir = 10
	},
/turf/open/floor/pod/dark,
/area/library_floors/floor_techsci)
"WT" = (
/obj/structure/railing{
	name = "invincible railing";
	resistance_flags = 64;
	dir = 1
	},
/obj/effect/turf_decal/trimline/purple/filled/line{
	dir = 1
	},
/obj/structure/fluff/big_chain{
	pixel_y = 12
	},
/turf/open/floor/pod/light,
/area/library_floors/floor_techsci)
"Xk" = (
/obj/machinery/modular_computer/console{
	dir = 1
	},
/turf/open/floor/pod/dark,
/area/library_floors/floor_techsci)
"Xt" = (
/turf/open/floor/fakepit{
	density = 1
	},
/area/library_floors/floor_techsci)
"Yz" = (
/obj/effect/turf_decal/trimline/white/filled/line{
	pixel_y = 10
	},
/turf/open/floor/plating/ashplanet,
/area/library_floors/floor_techsci)
"YE" = (
/obj/effect/turf_decal/trimline/purple/filled/line{
	dir = 10
	},
/obj/structure/bookcase/random/nonfiction,
/turf/open/floor/pod/dark,
/area/library_floors/floor_techsci)
"YF" = (
/obj/structure/flora/rock,
/turf/open/floor/plating/ashplanet,
/area/library_floors/floor_techsci)
"Za" = (
/obj/structure/railing{
	name = "invincible railing";
	resistance_flags = 64;
	dir = 1
	},
/obj/effect/decal/cleanable/dirt,
/obj/effect/turf_decal/trimline/purple/filled/line{
	dir = 1
	},
/obj/structure/fluff/big_chain{
	pixel_y = 12
	},
/turf/open/floor/pod/light,
/area/library_floors/floor_techsci)
"Zz" = (
/obj/structure/railing{
	name = "invincible railing";
	resistance_flags = 64;
	dir = 1
	},
/obj/effect/decal/cleanable/glass,
/obj/effect/turf_decal/trimline/purple/filled/line{
	dir = 1
	},
/obj/structure/fluff/big_chain{
	pixel_y = 12
	},
/turf/open/floor/pod/light,
/area/library_floors/floor_techsci)
"ZK" = (
/obj/effect/turf_decal/trimline/yellow/filled/line,
/obj/structure/mecha_wreckage,
/turf/open/floor/plating/ashplanet,
/area/library_floors/floor_techsci)

(1,1,1) = {"
Hk
Hk
Hk
Hk
Hk
Hk
Hk
BF
BF
BF
BF
BF
BF
BF
BF
BF
BF
BF
BF
Hk
Hk
Hk
Hk
Hk
"}
(2,1,1) = {"
Hk
Hk
Hk
Hk
Hk
Hk
Hk
BF
EZ
bF
eJ
bF
eJ
eJ
bF
eJ
bF
YE
BF
Hk
Hk
Hk
Hk
Hk
"}
(3,1,1) = {"
Hk
Hk
Hk
Hk
Hk
Hk
Hk
BF
xo
Cu
Ck
Cu
Ck
Ck
Cu
Ck
Cu
MV
BF
Hk
Hk
Hk
Hk
Hk
"}
(4,1,1) = {"
Hk
Hk
Hk
Hk
Hk
Hk
Hk
BF
gN
Cu
Cu
Cu
Cu
Cu
Cu
Cu
Cu
Uk
BF
Hk
Hk
Hk
Hk
Hk
"}
(5,1,1) = {"
Hk
Hk
Hk
Hk
Hk
BF
BF
BF
Os
Cu
Cu
Cu
Cu
Cu
Cu
Cu
Cu
Uk
BF
BF
BF
Hk
Hk
Hk
"}
(6,1,1) = {"
Hk
Hk
Hk
Hk
Hk
BF
WM
aH
Os
Cu
Cu
Cu
Cu
aB
Cu
Cu
Cu
Uk
aH
WM
BF
Hk
Hk
Hk
"}
(7,1,1) = {"
Hk
Hk
Hk
Hk
Hk
BF
BF
BF
Os
Cu
Cu
Cu
Cu
Cu
Cu
Cu
Cu
Uk
BF
BF
BF
Hk
Hk
Hk
"}
(8,1,1) = {"
Hk
Hk
Hk
Hk
Hk
Hk
Hk
BF
gN
Cu
KG
Ep
iz
Ep
Ep
HW
Cu
Uk
BF
Hk
Hk
Hk
Hk
Hk
"}
(9,1,1) = {"
Hk
Hk
Hk
Hk
Hk
Hk
Hk
BF
js
Ep
kk
ty
eN
eN
iM
js
Ep
kk
BF
Hk
Hk
Hk
Hk
Hk
"}
(10,1,1) = {"
Hk
Hk
Hk
BF
BF
BF
BF
BF
aH
rN
or
rN
aH
aH
rN
or
rN
aH
BF
BF
BF
BF
BF
Hk
"}
(11,1,1) = {"
Hk
Hk
Hk
BF
Xt
Xt
Xt
Xt
RW
bi
bi
bi
Kt
fW
bi
bi
Yz
mH
Xt
Xt
Xt
Xt
BF
Hk
"}
(12,1,1) = {"
Hk
Hk
Hk
BF
Xt
Xt
Xt
Xt
VC
bi
bi
Yz
Kt
fW
lg
bi
bi
rY
Xt
Xt
Xt
Xt
BF
Hk
"}
(13,1,1) = {"
Hk
Hk
Hk
BF
Xt
Xt
Xt
Xt
Cl
bi
bi
bi
Kt
fW
Yz
bi
bi
rY
Xt
Xt
Xt
Xt
BF
Hk
"}
(14,1,1) = {"
Hk
Hk
Hk
BF
Xt
Xt
Xt
Xt
WT
bi
rK
KL
Kt
fW
bi
bi
bi
Ki
Xt
Xt
Xt
Xt
BF
Hk
"}
(15,1,1) = {"
Hk
Hk
Hk
BF
Xt
Xt
Xt
Xt
VC
Yz
bi
bi
Kt
fW
bi
bi
bi
rY
Xt
Xt
Xt
Xt
BF
Hk
"}
(16,1,1) = {"
Hk
Hk
Hk
BF
Xt
Xt
Xt
Xt
VC
bi
bi
bi
Kt
Am
bi
bi
Yz
rY
Xt
Xt
Xt
Xt
BF
Hk
"}
(17,1,1) = {"
Hk
Hk
Hk
BF
Xt
Xt
Xt
Xt
VC
bi
bi
bi
Kt
fW
bi
bi
bi
rY
Xt
Xt
Xt
Xt
BF
Hk
"}
(18,1,1) = {"
Hk
Hk
Hk
BF
Xt
Xt
Xt
Xt
WT
bi
bi
Yz
Wg
fW
bi
rK
sm
zb
Xt
Xt
Xt
Xt
BF
Hk
"}
(19,1,1) = {"
Hk
Hk
Hk
BF
Xt
Xt
Xt
Xt
VC
bi
Qs
bi
Kt
fW
Yz
bi
bi
rY
Xt
Xt
Xt
Xt
BF
Hk
"}
(20,1,1) = {"
Hk
Hk
Hk
BF
Xt
Xt
Xt
Xt
VC
bi
lg
bi
Kt
fW
bi
bi
bi
rY
Xt
Xt
Xt
Xt
BF
Hk
"}
(21,1,1) = {"
Hk
Hk
Hk
BF
Xt
Xt
Xt
Xt
Cl
Yz
bi
bi
Kt
fW
bi
YF
bi
rY
Xt
Xt
Xt
Xt
BF
Hk
"}
(22,1,1) = {"
Hk
Hk
Hk
BF
Xt
Xt
Xt
Xt
WT
bi
bi
bi
Kt
fW
bi
bi
Yz
zb
Xt
Xt
Xt
Xt
BF
Hk
"}
(23,1,1) = {"
Hk
Hk
Hk
BF
Xt
Xt
Xt
Xt
VC
bi
bi
rK
Kt
fW
cU
bi
bi
rY
Xt
Xt
Xt
Xt
BF
Hk
"}
(24,1,1) = {"
Hk
Hk
Hk
BF
Xt
Xt
Xt
Xt
VC
bi
bi
Yz
Kt
fW
bi
bi
bi
rY
Xt
Xt
Xt
Xt
BF
Hk
"}
(25,1,1) = {"
Hk
Hk
Hk
BF
Xt
Xt
Xt
Xt
VC
bi
bi
bi
Kt
fW
Yz
bi
bi
dI
Xt
Xt
Xt
Xt
BF
Hk
"}
(26,1,1) = {"
Hk
Hk
Hk
BF
Xt
Xt
Xt
Xt
WT
bi
bi
bi
Kt
fW
bi
bi
bi
zb
Xt
Xt
Xt
Xt
BF
Hk
"}
(27,1,1) = {"
Hk
Hk
Hk
BF
Ks
Xt
Xt
Xt
VC
Yz
bi
YF
Kt
fW
bi
bi
bi
rY
Xt
Xt
Xt
Xt
BF
Hk
"}
(28,1,1) = {"
Hk
Hk
Hk
BF
Xt
Xt
Xt
Xt
VC
bi
bi
bi
Wg
fW
bi
bi
Yz
rY
Xt
Xt
Xt
Ks
BF
Hk
"}
(29,1,1) = {"
Hk
Hk
Hk
BF
Xt
Xt
Xt
Xt
VC
bi
sm
bi
Kt
fW
bi
rK
bi
rY
Xt
Xt
Xt
Xt
BF
Hk
"}
(30,1,1) = {"
Hk
Hk
Hk
BF
Xt
Xt
Xt
Xt
WT
bi
bi
Cq
Kt
fW
bi
bi
bi
zb
Xt
Xt
Xt
Xt
BF
Hk
"}
(31,1,1) = {"
Hk
Hk
Hk
BF
Xt
Xt
Xt
Xt
VC
bi
bi
bi
Kt
fW
Yz
bi
bi
rY
Xt
Xt
Xt
Xt
BF
Hk
"}
(32,1,1) = {"
Hk
Hk
Hk
BF
Xt
Xt
Xt
Xt
VC
bi
bi
bi
JL
fW
Me
bi
bi
rY
Xt
Xt
Xt
Xt
BF
Hk
"}
(33,1,1) = {"
Hk
Hk
Hk
BF
Xt
Xt
Xt
Xt
VC
Yz
bi
bi
Kt
fW
bi
bi
bi
rY
Xt
Xt
Xt
Xt
BF
Hk
"}
(34,1,1) = {"
Hk
Hk
Hk
BF
Xt
Xt
Xt
Xt
Zz
bi
bi
bi
Kt
fW
bi
bi
Yz
zb
Xt
Xt
Xt
Xt
BF
Hk
"}
(35,1,1) = {"
Hk
Hk
Hk
BF
Xt
Xt
Xt
Xt
VC
bi
bi
bi
Kt
fW
bi
bi
bi
rY
Xt
Xt
Xt
Xt
BF
Hk
"}
(36,1,1) = {"
Hk
Hk
Hk
BF
Xt
Xt
Xt
Xt
VC
bi
bi
Yz
KX
fW
bi
bi
cU
dI
Xt
Xt
Xt
Xt
BF
Hk
"}
(37,1,1) = {"
Hk
Hk
Hk
BF
Xt
Xt
Xt
Xt
VC
bi
bi
bi
Kt
fW
Yz
bi
bi
rY
Xt
Xt
Xt
Xt
BF
Hk
"}
(38,1,1) = {"
Hk
Hk
Hk
BF
Xt
Xt
Xt
Xt
WT
bi
bi
bi
Kt
fW
rK
bi
bi
zb
Xt
Xt
Xt
Xt
BF
Hk
"}
(39,1,1) = {"
Hk
Hk
Hk
BF
Xt
Xt
Xt
Xt
VC
Yz
bi
bi
ZK
fW
bi
bi
bi
rY
Xt
Xt
Xt
Xt
BF
Hk
"}
(40,1,1) = {"
Hk
Hk
Hk
BF
Xt
Xt
Xt
Xt
VC
bi
bi
bi
Kt
fW
bi
bi
Yz
rY
Xt
Xt
Xt
Xt
BF
Hk
"}
(41,1,1) = {"
Hk
Hk
Hk
BF
Xt
Xt
Xt
Xt
VC
bi
bi
bi
Kt
fW
bi
bi
bi
rY
Xt
Xt
Xt
Xt
BF
Hk
"}
(42,1,1) = {"
Hk
Hk
Hk
BF
Xt
Xt
Xt
Xt
Za
bi
YF
Yz
Kt
fW
bi
bi
bi
zb
Xt
Xt
Xt
Xt
BF
Hk
"}
(43,1,1) = {"
Hk
Hk
Hk
BF
Xt
Xt
Xt
Xt
VC
bi
bi
bi
Wg
fW
Yz
bi
bi
rY
Xt
Xt
Xt
Xt
BF
Hk
"}
(44,1,1) = {"
Hk
Hk
Hk
BF
Xt
Xt
Xt
Xt
VC
bi
bi
bi
Kt
fW
bi
bi
rK
rY
Xt
Xt
Xt
Xt
BF
Hk
"}
(45,1,1) = {"
Hk
Hk
Hk
BF
Xt
Xt
Xt
Xt
VC
Yz
bi
bi
Kt
fW
bi
bi
bi
rY
Xt
Xt
Xt
Xt
BF
Hk
"}
(46,1,1) = {"
Hk
Hk
Hk
BF
Xt
Xt
Xt
Xt
WT
bi
bi
bi
Kt
fW
bi
bi
Yz
zb
Xt
Xt
Xt
Xt
BF
Hk
"}
(47,1,1) = {"
Hk
Hk
Hk
BF
Xt
Xt
Xt
Xt
VC
bi
rK
bi
Kt
fW
bi
bi
bi
rY
Xt
Xt
Xt
Xt
BF
Hk
"}
(48,1,1) = {"
Hk
Hk
Hk
BF
Xt
Xt
Xt
Xt
FY
bi
bi
Yz
Kt
fW
bi
bi
bi
nJ
Xt
Xt
Xt
Xt
BF
Hk
"}
(49,1,1) = {"
Hk
Hk
Hk
BF
BF
BF
BF
BF
aH
rN
or
rN
aH
aH
rN
or
rN
aH
BF
BF
BF
BF
BF
Hk
"}
(50,1,1) = {"
Hk
Hk
Hk
Hk
Hk
Hk
Hk
BF
Fg
bF
WS
ty
eN
eN
ty
Fg
Iy
Lf
BF
Hk
Hk
Hk
Hk
Hk
"}
(51,1,1) = {"
Hk
Hk
Hk
Hk
Hk
Hk
Hk
Gu
gN
Cu
PB
bF
bF
bF
Db
yO
Uk
Xk
BF
BF
BF
BF
Hk
Hk
"}
(52,1,1) = {"
Hk
Hk
Hk
Hk
Hk
Hk
Hk
BF
BN
Ep
iz
Ep
HW
Cu
Cu
Cu
PB
WS
aH
gG
Hg
BF
Hk
Hk
"}
(53,1,1) = {"
Hk
Hk
Hk
Hk
Hk
Hk
Hk
BF
qa
iM
eN
ty
gN
Cu
Cu
Cu
Cu
Uk
aH
Us
Uk
BF
Hk
Hk
"}
(54,1,1) = {"
Hk
Hk
Hk
Hk
Hk
Hk
Hk
BF
qa
eN
wX
eN
PY
aB
Cu
Cu
KG
kk
rN
gN
Uk
BF
Hk
Hk
"}
(55,1,1) = {"
Hk
Hk
Hk
Hk
Hk
Hk
Hk
BF
qa
eN
Cu
sF
gN
Cu
Cu
Cu
Uk
Xk
BF
gN
go
BF
Hk
Hk
"}
(56,1,1) = {"
Hk
Hk
Hk
Hk
Hk
Hk
Hk
BF
qa
ty
eN
iM
gN
Cu
Cu
Cu
PB
WS
aH
gN
aq
BF
Hk
Hk
"}
(57,1,1) = {"
Hk
Hk
Hk
Hk
Hk
Hk
Hk
BF
mN
bF
bF
bF
yO
Cu
Cu
Cu
Cu
Uk
aH
gN
Uk
BF
Hk
Hk
"}
(58,1,1) = {"
Hk
Hk
Hk
Hk
Hk
Hk
Hk
BF
xo
Cu
Ck
Cu
Ck
Ck
Cu
Ck
Cu
MV
BF
js
kk
BF
Hk
Hk
"}
(59,1,1) = {"
Hk
Hk
Hk
Hk
Hk
Hk
Hk
BF
Kd
Ep
UQ
Ep
UQ
UQ
Ep
UQ
Ep
BR
BF
BF
BF
BF
Hk
Hk
"}
(60,1,1) = {"
Hk
Hk
Hk
Hk
Hk
Hk
Hk
BF
BF
BF
BF
BF
BF
BF
BF
BF
BF
BF
BF
Hk
Hk
Hk
Hk
Hk
"}
