//MAP CONVERTED BY dmm2tgm.py THIS HEADER COMMENT PREVENTS RECONVERSION, DO NOT REMOVE
"a" = (
/turf/open/floor/plating/dirt/jungle/wasteland,
/area/library_floors/floor_art)
"b" = (
/turf/open/floor/fakepit{
	density = 1
	},
/area/library_floors/floor_art)
"d" = (
/obj/effect/decal/cleanable/greenglow,
/turf/open/floor/plating/dirt/jungle/wasteland,
/area/library_floors/floor_art)
"f" = (
/obj/structure/alien/resin/wall/creature,
/obj/item/wallframe/painting,
/turf/closed/indestructible/rock,
/area/library_floors/floor_art)
"g" = (
/obj/structure/table/wood,
/obj/item/reagent_containers/food/drinks/beer,
/obj/item/reagent_containers/food/drinks/beer{
	pixel_x = -10;
	pixel_y = -7
	},
/obj/item/reagent_containers/food/drinks/beer{
	pixel_x = -9
	},
/turf/open/floor/plating/dirt/jungle/wasteland,
/area/library_floors/floor_art)
"h" = (
/obj/item/broken_bottle,
/obj/structure/table/wood,
/turf/open/floor/plating/dirt/jungle/wasteland,
/area/library_floors/floor_art)
"i" = (
/obj/item/book/random{
	pixel_y = -11;
	pixel_x = -5
	},
/obj/item/book/random{
	pixel_y = 2
	},
/obj/item/book/random{
	pixel_y = 2;
	pixel_x = 7
	},
/obj/item/book/random{
	pixel_x = -5
	},
/obj/item/book/random{
	pixel_x = 7;
	pixel_y = -8
	},
/obj/structure/table/wood,
/turf/open/floor/plating/dirt/jungle/wasteland,
/area/library_floors/floor_art)
"j" = (
/obj/structure/table/wood,
/obj/machinery/chem_dispenser/drinks/beer/fullupgrade{
	dir = 1
	},
/turf/open/floor/plating/dirt/jungle/wasteland,
/area/library_floors/floor_art)
"k" = (
/obj/structure/fluff/arc/angela,
/turf/open/floor/plating/dirt/jungle/wasteland,
/area/library_floors/floor_art)
"l" = (
/turf/open/space/basic,
/area/space)
"m" = (
/obj/item/storage/crayons,
/turf/open/floor/plating/dirt/jungle/wasteland,
/area/library_floors/floor_art)
"o" = (
/obj/item/paint/red,
/turf/open/floor/plating/dirt/jungle/wasteland,
/area/library_floors/floor_art)
"p" = (
/obj/structure/statue/plasma/scientist,
/turf/open/floor/plating/dirt/jungle/wasteland,
/area/library_floors/floor_art)
"q" = (
/obj/structure/statue/sandstone/venus{
	anchored = 1
	},
/turf/open/floor/plating/dirt/jungle/wasteland,
/area/library_floors/floor_art)
"r" = (
/obj/structure/bookcase/random/fiction,
/turf/open/floor/plating/dirt/jungle/wasteland,
/area/library_floors/floor_art)
"s" = (
/obj/item/paint/white,
/turf/open/floor/plating/dirt/jungle/wasteland,
/area/library_floors/floor_art)
"t" = (
/obj/structure/firetree,
/turf/open/floor/plating/dirt/jungle/wasteland,
/area/library_floors/floor_art)
"v" = (
/obj/item/paint,
/turf/open/floor/plating/dirt/jungle/wasteland,
/area/library_floors/floor_art)
"w" = (
/obj/item/toy/crayon/blue,
/turf/open/floor/plating/dirt/jungle/wasteland,
/area/library_floors/floor_art)
"y" = (
/obj/item/toy/plush/netzach,
/obj/item/reagent_containers/food/drinks/beer{
	pixel_x = -10;
	pixel_y = -7
	},
/obj/item/reagent_containers/food/drinks/beer{
	pixel_x = 11;
	pixel_y = -9
	},
/obj/effect/decal/cleanable/vomit,
/turf/open/floor/plating/dirt/jungle/wasteland,
/area/library_floors/floor_art)
"z" = (
/obj/item/grown/log/tree,
/turf/open/floor/plating/dirt/jungle/wasteland,
/area/library_floors/floor_art)
"B" = (
/obj/effect/light_emitter{
	light_power = 4;
	light_range = 25;
	set_cap = 3;
	set_luminosity = 24
	},
/turf/open/floor/plating/dirt/jungle/wasteland,
/area/library_floors/floor_art)
"D" = (
/obj/structure/easel,
/obj/item/canvas/nineteen_nineteen,
/turf/open/floor/plating/dirt/jungle/wasteland,
/area/library_floors/floor_art)
"G" = (
/obj/structure/fluff/drake_statue{
	pixel_x = 0;
	pixel_y = 0
	},
/turf/open/floor/plating/dirt/jungle/wasteland,
/area/library_floors/floor_art)
"I" = (
/turf/closed/indestructible/fakeglass,
/area/library_floors/floor_art)
"J" = (
/obj/item/toy/crayon/rainbow,
/turf/open/floor/plating/dirt/jungle/wasteland,
/area/library_floors/floor_art)
"N" = (
/obj/item/toy/crayon,
/turf/open/floor/plating/dirt/jungle/wasteland,
/area/library_floors/floor_art)
"R" = (
/obj/item/book/random{
	pixel_y = -11;
	pixel_x = -5
	},
/obj/item/book/random{
	pixel_y = 2
	},
/obj/item/book/random{
	pixel_y = 2;
	pixel_x = 7
	},
/obj/item/book/random{
	pixel_x = -5
	},
/obj/item/book/random{
	pixel_x = 7;
	pixel_y = -8
	},
/turf/open/floor/plating/dirt/jungle/wasteland,
/area/library_floors/floor_art)
"S" = (
/obj/item/broken_bottle,
/turf/open/floor/plating/dirt/jungle/wasteland,
/area/library_floors/floor_art)
"U" = (
/obj/structure/statue/sandstone/venus{
	anchored = 1;
	dir = 8
	},
/turf/open/floor/plating/dirt/jungle/wasteland,
/area/library_floors/floor_art)
"V" = (
/obj/effect/light_emitter{
	light_power = 4;
	light_range = 30;
	set_cap = 3;
	set_luminosity = 24
	},
/turf/open/floor/plating/dirt/jungle/wasteland,
/area/library_floors/floor_art)
"Y" = (
/obj/structure/alien/resin/wall/creature,
/turf/closed/indestructible/rock,
/area/library_floors/floor_art)

(1,1,1) = {"
l
l
l
l
l
l
l
Y
Y
Y
Y
Y
Y
Y
Y
Y
Y
Y
Y
l
l
l
l
l
"}
(2,1,1) = {"
l
l
l
l
l
l
l
Y
a
a
a
a
a
a
a
a
a
a
Y
Y
Y
Y
l
l
"}
(3,1,1) = {"
l
l
l
l
l
l
l
Y
a
a
a
r
R
a
a
a
R
a
I
a
G
Y
l
l
"}
(4,1,1) = {"
l
l
l
l
l
l
l
Y
a
a
t
a
a
a
a
a
a
a
I
a
a
Y
l
l
"}
(5,1,1) = {"
l
l
l
l
Y
Y
Y
Y
S
a
a
r
a
a
a
a
a
a
Y
Y
Y
Y
l
l
"}
(6,1,1) = {"
l
l
l
l
f
a
p
I
a
a
a
a
a
V
a
a
a
r
Y
l
l
l
l
l
"}
(7,1,1) = {"
l
l
l
l
f
a
p
I
a
R
a
a
N
R
a
a
t
a
Y
l
l
l
l
l
"}
(8,1,1) = {"
l
l
l
l
Y
Y
Y
Y
a
a
m
w
a
a
a
a
a
r
Y
l
l
l
l
l
"}
(9,1,1) = {"
l
l
l
l
l
l
l
Y
a
a
a
D
a
a
a
a
a
a
Y
l
l
l
l
l
"}
(10,1,1) = {"
l
l
l
Y
Y
Y
Y
Y
f
Y
a
Y
a
a
Y
Y
Y
f
Y
Y
Y
Y
Y
l
"}
(11,1,1) = {"
l
l
l
Y
b
b
b
b
a
a
a
a
a
a
a
a
a
a
b
b
b
b
Y
l
"}
(12,1,1) = {"
l
l
l
Y
b
b
b
b
b
a
a
a
a
a
a
a
a
a
b
b
b
b
Y
l
"}
(13,1,1) = {"
l
l
l
Y
b
b
b
b
a
a
d
a
a
a
a
a
a
a
b
b
b
b
Y
l
"}
(14,1,1) = {"
l
l
l
Y
b
b
b
b
a
a
a
a
a
a
a
a
a
b
b
b
b
b
Y
l
"}
(15,1,1) = {"
l
l
l
Y
b
b
b
b
a
a
a
z
V
q
a
d
a
a
b
b
b
a
Y
l
"}
(16,1,1) = {"
l
l
l
Y
b
b
b
b
a
a
r
a
a
a
a
a
a
a
b
b
a
a
Y
l
"}
(17,1,1) = {"
l
l
l
Y
b
b
a
a
a
t
a
a
a
a
a
a
a
a
b
b
r
a
Y
l
"}
(18,1,1) = {"
l
l
l
Y
b
a
a
b
a
a
r
a
a
a
a
a
R
a
a
t
a
b
Y
l
"}
(19,1,1) = {"
l
l
l
Y
b
a
a
b
a
a
a
a
a
a
a
a
a
a
a
a
r
b
Y
l
"}
(20,1,1) = {"
l
l
l
Y
b
a
a
a
a
a
a
a
a
a
a
a
a
a
b
a
a
a
Y
l
"}
(21,1,1) = {"
l
l
l
Y
b
a
a
a
a
d
a
a
a
a
a
a
a
a
b
b
d
a
Y
l
"}
(22,1,1) = {"
l
l
l
Y
b
a
a
a
a
a
a
a
a
a
a
z
a
a
b
b
a
a
Y
l
"}
(23,1,1) = {"
l
l
l
Y
b
b
a
b
a
a
a
a
a
S
a
a
a
a
b
a
a
b
Y
l
"}
(24,1,1) = {"
l
l
l
Y
b
a
a
b
a
a
a
a
a
a
a
a
a
a
a
a
a
b
Y
l
"}
(25,1,1) = {"
l
l
l
Y
b
b
b
b
a
a
a
a
a
a
a
a
a
a
a
a
a
b
Y
l
"}
(26,1,1) = {"
l
l
l
Y
b
b
b
b
a
a
a
a
a
a
r
a
a
a
b
b
a
a
Y
l
"}
(27,1,1) = {"
l
l
l
Y
b
b
b
b
a
R
a
a
a
t
a
a
a
b
b
b
b
a
Y
l
"}
(28,1,1) = {"
l
l
l
Y
b
b
b
b
a
a
a
a
a
a
r
a
a
a
b
b
b
b
Y
l
"}
(29,1,1) = {"
l
l
l
Y
b
b
b
b
b
a
a
a
k
V
R
a
a
a
b
b
b
b
Y
l
"}
(30,1,1) = {"
l
l
l
Y
b
b
b
b
a
a
a
a
a
a
a
a
a
a
b
b
b
b
Y
l
"}
(31,1,1) = {"
l
l
l
Y
b
b
b
b
a
a
a
a
a
a
a
a
a
a
b
b
b
b
Y
l
"}
(32,1,1) = {"
l
l
l
Y
b
b
b
b
a
a
a
a
a
a
a
a
a
a
b
b
b
b
Y
l
"}
(33,1,1) = {"
l
l
l
Y
b
b
b
a
a
a
a
a
a
a
a
a
a
a
b
b
b
b
Y
l
"}
(34,1,1) = {"
l
l
l
Y
b
b
a
a
a
a
z
a
a
a
a
a
a
a
b
b
b
b
Y
l
"}
(35,1,1) = {"
l
l
l
Y
b
a
a
b
a
a
a
a
a
a
a
a
a
a
a
b
a
b
Y
l
"}
(36,1,1) = {"
l
l
l
Y
b
a
a
b
a
a
a
a
a
a
a
a
a
a
a
a
r
S
Y
l
"}
(37,1,1) = {"
l
l
l
Y
b
a
a
a
a
a
a
a
a
a
a
a
d
a
a
t
a
a
Y
l
"}
(38,1,1) = {"
l
l
l
Y
b
a
a
a
a
S
a
a
a
a
a
a
B
a
a
a
r
a
Y
l
"}
(39,1,1) = {"
l
l
l
Y
b
a
d
a
a
a
a
a
a
a
R
a
a
a
a
a
a
a
Y
l
"}
(40,1,1) = {"
l
l
l
Y
b
a
a
a
a
a
a
a
a
a
a
a
a
a
S
a
b
b
Y
l
"}
(41,1,1) = {"
l
l
l
Y
b
b
a
a
a
a
a
a
a
a
a
a
a
a
b
b
b
b
Y
l
"}
(42,1,1) = {"
l
l
l
Y
b
b
a
b
a
a
r
R
a
a
a
a
z
a
b
b
b
b
Y
l
"}
(43,1,1) = {"
l
l
l
Y
b
b
a
a
a
t
a
a
a
a
a
a
a
a
b
b
b
b
Y
l
"}
(44,1,1) = {"
l
l
l
Y
b
b
b
b
a
a
r
a
V
U
a
a
a
a
b
b
b
b
Y
l
"}
(45,1,1) = {"
l
l
l
Y
b
b
b
b
a
a
a
a
a
a
a
a
a
b
b
b
b
b
Y
l
"}
(46,1,1) = {"
l
l
l
Y
b
b
b
b
a
a
a
a
a
d
a
a
a
a
b
b
b
b
Y
l
"}
(47,1,1) = {"
l
l
l
Y
b
b
b
b
b
a
a
a
a
a
a
a
a
a
b
b
b
b
Y
l
"}
(48,1,1) = {"
l
l
l
Y
b
b
b
b
a
a
a
a
a
a
a
a
a
a
b
b
b
b
Y
l
"}
(49,1,1) = {"
l
l
l
Y
Y
Y
Y
Y
f
Y
Y
Y
a
a
Y
a
Y
f
Y
Y
Y
Y
Y
l
"}
(50,1,1) = {"
l
l
l
l
l
l
l
Y
a
a
a
a
a
a
a
a
a
a
Y
l
l
l
l
l
"}
(51,1,1) = {"
l
l
l
l
l
l
l
Y
R
a
a
r
a
a
a
R
a
a
Y
l
l
l
l
l
"}
(52,1,1) = {"
l
l
l
l
l
l
l
Y
a
a
t
a
a
a
a
a
a
a
Y
l
l
l
l
l
"}
(53,1,1) = {"
l
l
l
l
l
l
l
Y
a
a
a
r
a
d
a
a
a
r
Y
l
l
l
l
l
"}
(54,1,1) = {"
l
l
l
l
l
l
l
Y
S
J
v
a
a
a
R
a
t
a
Y
l
l
l
l
l
"}
(55,1,1) = {"
l
l
l
l
l
l
l
Y
a
a
w
a
a
V
a
a
a
r
Y
l
l
l
l
l
"}
(56,1,1) = {"
l
l
l
l
l
l
l
Y
D
a
d
a
r
a
a
a
h
a
Y
l
l
l
l
l
"}
(57,1,1) = {"
l
l
l
l
l
l
l
Y
a
s
a
t
a
a
a
a
g
y
Y
l
l
l
l
l
"}
(58,1,1) = {"
l
l
l
l
l
l
l
Y
D
R
a
a
r
a
a
a
i
a
Y
l
l
l
l
l
"}
(59,1,1) = {"
l
l
l
l
l
l
l
Y
o
a
a
a
a
a
a
a
j
a
Y
l
l
l
l
l
"}
(60,1,1) = {"
l
l
l
l
l
l
l
Y
Y
Y
Y
Y
Y
Y
Y
Y
Y
Y
Y
l
l
l
l
l
"}
