//MAP CONVERTED BY dmm2tgm.py THIS HEADER COMMENT PREVENTS RECONVERSION, DO NOT REMOVE
"ad" = (
/obj/structure/lattice/catwalk,
/obj/structure/railing{
	name = "invincible railing";
	resistance_flags = 64
	},
/turf/open/lava,
/area/library_floors/floor_language)
"aY" = (
/obj/effect/turf_decal/trimline/red/filled/line{
	dir = 10
	},
/obj/effect/decal/cleanable/ash,
/turf/open/indestructible/hotelwood,
/area/library_floors/floor_language)
"cw" = (
/obj/structure/railing{
	dir = 1;
	name = "invincible railing";
	resistance_flags = 64
	},
/turf/open/floor/plating/beach/sand,
/area/library_floors/floor_language)
"ei" = (
/obj/effect/turf_decal/trimline/red/filled/warning{
	dir = 8
	},
/turf/open/floor/stone,
/area/library_floors/floor_language)
"eI" = (
/obj/item/target,
/obj/effect/turf_decal/trimline/red/filled/line{
	dir = 1
	},
/turf/open/indestructible/hotelwood,
/area/library_floors/floor_language)
"fp" = (
/obj/effect/light_emitter{
	light_power = 4;
	light_range = 30;
	set_cap = 3;
	set_luminosity = 24
	},
/turf/open/floor/stone,
/area/library_floors/floor_language)
"gU" = (
/obj/effect/turf_decal/trimline/red/filled/line,
/turf/open/floor/stone,
/area/library_floors/floor_language)
"hL" = (
/obj/effect/turf_decal/trimline/red/filled/line{
	dir = 1
	},
/turf/open/indestructible/hotelwood,
/area/library_floors/floor_language)
"hT" = (
/obj/structure/railing{
	dir = 4;
	name = "invincible railing";
	max_integrity = 1e+007
	},
/turf/open/floor/plating/beach/sand,
/area/library_floors/floor_language)
"hY" = (
/obj/item/target,
/obj/effect/turf_decal/trimline/red/filled/line{
	dir = 5
	},
/turf/open/indestructible/hotelwood,
/area/library_floors/floor_language)
"ib" = (
/obj/effect/turf_decal/trimline/red/filled/line{
	dir = 6
	},
/turf/open/indestructible/hotelwood,
/area/library_floors/floor_language)
"it" = (
/obj/structure/chair/comfy,
/turf/open/indestructible/hotelwood,
/area/library_floors/floor_language)
"ja" = (
/obj/effect/decal/cleanable/blood/drip,
/turf/open/floor/plating/beach/sand,
/area/library_floors/floor_language)
"jN" = (
/turf/open/floor/mineral/plastitanium,
/area/library_floors/floor_language)
"kV" = (
/obj/structure/weightmachine/weightlifter,
/obj/effect/decal/cleanable/blood/drip,
/turf/open/floor/plating/beach/sand,
/area/library_floors/floor_language)
"lP" = (
/obj/effect/light_emitter{
	light_power = 4;
	light_range = 30;
	set_cap = 3;
	set_luminosity = 24
	},
/turf/open/floor/plating/beach/sand,
/area/library_floors/floor_language)
"my" = (
/obj/structure/table/reinforced,
/obj/item/ego_weapon/city/shi_assassin,
/turf/open/floor/mineral/plastitanium,
/area/library_floors/floor_language)
"ou" = (
/obj/item/toy/plush/mosb,
/turf/open/floor/stone,
/area/library_floors/floor_language)
"pz" = (
/obj/structure/railing{
	name = "invincible railing";
	resistance_flags = 64
	},
/turf/open/floor/plating/beach/sand,
/area/library_floors/floor_language)
"qz" = (
/obj/effect/turf_decal/trimline/red/filled/line{
	dir = 4
	},
/turf/open/indestructible/hotelwood,
/area/library_floors/floor_language)
"rn" = (
/turf/open/indestructible/hotelwood,
/area/library_floors/floor_language)
"rr" = (
/obj/effect/decal/cleanable/cobweb/cobweb2,
/turf/open/floor/stone,
/area/library_floors/floor_language)
"rv" = (
/obj/structure/table/reinforced,
/obj/item/ego_weapon/city/seven,
/turf/open/floor/mineral/plastitanium,
/area/library_floors/floor_language)
"ry" = (
/obj/structure/table/wood,
/obj/item/lighter,
/turf/open/indestructible/hotelwood,
/area/library_floors/floor_language)
"rW" = (
/obj/effect/decal/cleanable/blood/gibs,
/turf/open/floor/stone,
/area/library_floors/floor_language)
"ss" = (
/obj/effect/decal/cleanable/blood,
/turf/open/floor/stone,
/area/library_floors/floor_language)
"sO" = (
/obj/effect/decal/cleanable/ash,
/obj/effect/turf_decal/trimline/red/filled/line{
	dir = 5
	},
/turf/open/indestructible/hotelwood,
/area/library_floors/floor_language)
"tK" = (
/obj/structure/table/wood,
/turf/open/indestructible/hotelwood,
/area/library_floors/floor_language)
"uL" = (
/obj/structure/window/reinforced/fulltile/indestructable,
/obj/structure/grille,
/turf/open/floor/stone,
/area/library_floors/floor_language)
"vb" = (
/obj/structure/table/reinforced,
/obj/item/ego_weapon/city/index,
/turf/open/floor/mineral/plastitanium,
/area/library_floors/floor_language)
"vX" = (
/obj/effect/decal/cleanable/cobweb,
/turf/open/floor/stone,
/area/library_floors/floor_language)
"we" = (
/obj/effect/turf_decal/trimline/red/filled/line{
	dir = 1
	},
/turf/open/floor/stone,
/area/library_floors/floor_language)
"wu" = (
/obj/machinery/computer/security/wooden_tv,
/obj/effect/turf_decal/trimline/red/filled/line{
	dir = 1
	},
/turf/open/indestructible/hotelwood,
/area/library_floors/floor_language)
"ww" = (
/obj/structure/bookcase/random/nonfiction,
/turf/open/indestructible/hotelwood,
/area/library_floors/floor_language)
"wP" = (
/obj/structure/table/wood,
/obj/item/storage/fancy/cigarettes/cigpack_robust,
/turf/open/indestructible/hotelwood,
/area/library_floors/floor_language)
"xb" = (
/obj/machinery/door/airlock/hatch,
/turf/open/floor/stone,
/area/library_floors/floor_language)
"xB" = (
/obj/structure/table/wood,
/obj/item/storage/fancy/cigarettes/cigpack_robustgold,
/turf/open/indestructible/hotelwood,
/area/library_floors/floor_language)
"yd" = (
/turf/open/floor/holofloor/basalt,
/area/library_floors/floor_language)
"yq" = (
/obj/effect/decal/cleanable/blood/splatter,
/turf/open/floor/plating/beach/sand,
/area/library_floors/floor_language)
"zF" = (
/obj/effect/turf_decal/trimline/red/filled/line,
/turf/open/indestructible/hotelwood,
/area/library_floors/floor_language)
"AF" = (
/obj/structure/table/reinforced,
/obj/item/ego_weapon/city/dawn/zwei,
/turf/open/floor/mineral/plastitanium,
/area/library_floors/floor_language)
"AW" = (
/turf/open/lava{
	density = 1
	},
/area/library_floors/floor_language)
"Bl" = (
/obj/structure/lattice/catwalk,
/obj/effect/light_emitter{
	light_power = 4;
	light_range = 30;
	set_cap = 3;
	set_luminosity = 24
	},
/turf/open/lava,
/area/library_floors/floor_language)
"Br" = (
/obj/structure/chair/comfy{
	dir = 1
	},
/obj/effect/turf_decal/trimline/red/filled/line,
/turf/open/indestructible/hotelwood,
/area/library_floors/floor_language)
"Di" = (
/obj/item/toy/plush/melt,
/turf/open/floor/stone,
/area/library_floors/floor_language)
"Dt" = (
/obj/effect/turf_decal/trimline/red/filled/line{
	dir = 9
	},
/turf/open/indestructible/hotelwood,
/area/library_floors/floor_language)
"DP" = (
/obj/effect/turf_decal/trimline/red/filled/warning{
	dir = 4
	},
/turf/open/floor/stone,
/area/library_floors/floor_language)
"El" = (
/obj/structure/lattice/catwalk,
/obj/structure/railing{
	name = "invincible railing";
	resistance_flags = 64;
	dir = 1
	},
/turf/open/lava,
/area/library_floors/floor_language)
"EB" = (
/turf/open/floor/plating/beach/sand,
/area/library_floors/floor_language)
"ED" = (
/obj/effect/decal/cleanable/ash,
/turf/open/indestructible/hotelwood,
/area/library_floors/floor_language)
"EU" = (
/obj/item/chair/wood/wings,
/obj/item/clothing/mask/cigarette,
/turf/open/indestructible/hotelwood,
/area/library_floors/floor_language)
"Fo" = (
/obj/structure/bookcase/random/nonfiction,
/turf/closed/indestructible/syndicate,
/area/library_floors/floor_language)
"Gb" = (
/obj/structure/lattice/catwalk,
/turf/open/lava,
/area/library_floors/floor_language)
"Gd" = (
/obj/structure/table/wood,
/obj/item/clothing/mask/cigarette,
/turf/open/indestructible/hotelwood,
/area/library_floors/floor_language)
"GM" = (
/obj/item/toy/plush/gebura,
/obj/item/ego_weapon/mimicry/kali{
	pixel_y = 5;
	pixel_x = 20
	},
/obj/item/clothing/mask/cigarette{
	pixel_x = -14;
	pixel_y = 1
	},
/turf/open/floor/stone,
/area/library_floors/floor_language)
"GT" = (
/obj/effect/decal/cleanable/blood,
/obj/effect/mob_spawn/human/corpse/assistant,
/turf/open/floor/stone,
/area/library_floors/floor_language)
"HC" = (
/obj/structure/weightmachine/weightlifter,
/turf/open/floor/plating/beach/sand,
/area/library_floors/floor_language)
"HM" = (
/obj/structure/railing{
	dir = 5;
	max_integrity = 1e+007;
	name = "invincible railing"
	},
/turf/open/floor/plating/beach/sand,
/area/library_floors/floor_language)
"IM" = (
/obj/effect/decal/cleanable/blood/gibs,
/obj/effect/mob_spawn/human/corpse/assistant,
/turf/open/floor/stone,
/area/library_floors/floor_language)
"Jq" = (
/obj/effect/decal/cleanable/blood/gibs/core,
/turf/open/floor/stone,
/area/library_floors/floor_language)
"JF" = (
/obj/structure/table/reinforced,
/obj/item/ego_weapon/city/bladelineage,
/turf/open/floor/mineral/plastitanium,
/area/library_floors/floor_language)
"LT" = (
/obj/structure/table/reinforced,
/obj/item/gun/ego_gun/city/thumb,
/turf/open/floor/mineral/plastitanium,
/area/library_floors/floor_language)
"Mp" = (
/obj/structure/bookcase/random,
/turf/closed/indestructible/syndicate,
/area/library_floors/floor_language)
"MR" = (
/turf/closed/indestructible/syndicate,
/area/library_floors/floor_language)
"Ov" = (
/obj/structure/railing{
	dir = 10;
	max_integrity = 1e+007;
	name = "invincible railing"
	},
/turf/open/floor/plating/beach/sand,
/area/library_floors/floor_language)
"Ox" = (
/obj/structure/railing{
	dir = 8;
	max_integrity = 1e+007;
	name = "invincible railing"
	},
/turf/open/floor/plating/beach/sand,
/area/library_floors/floor_language)
"ON" = (
/obj/structure/railing{
	dir = 9;
	max_integrity = 1e+007;
	name = "invincible railing"
	},
/turf/open/floor/plating/beach/sand,
/area/library_floors/floor_language)
"PV" = (
/obj/structure/chair/comfy{
	dir = 1
	},
/turf/open/indestructible/hotelwood,
/area/library_floors/floor_language)
"Qd" = (
/obj/structure/weightmachine/stacklifter,
/turf/open/floor/plating/beach/sand,
/area/library_floors/floor_language)
"Rm" = (
/obj/item/chair/wood/wings{
	dir = 4
	},
/obj/item/clothing/mask/cigarette,
/turf/open/indestructible/hotelwood,
/area/library_floors/floor_language)
"Sf" = (
/obj/item/chair/wood,
/obj/effect/decal/cleanable/ash,
/turf/open/indestructible/hotelwood,
/area/library_floors/floor_language)
"Sw" = (
/obj/structure/table/reinforced,
/obj/item/ego_weapon/city/kurokumo,
/turf/open/floor/mineral/plastitanium,
/area/library_floors/floor_language)
"TW" = (
/obj/item/clothing/mask/cigarette,
/turf/open/indestructible/hotelwood,
/area/library_floors/floor_language)
"Ur" = (
/obj/effect/decal/cleanable/ash,
/obj/effect/turf_decal/trimline/red/filled/line{
	dir = 8
	},
/turf/open/indestructible/hotelwood,
/area/library_floors/floor_language)
"UV" = (
/obj/effect/turf_decal/trimline/red/filled/line{
	dir = 8
	},
/turf/open/indestructible/hotelwood,
/area/library_floors/floor_language)
"VQ" = (
/obj/structure/railing{
	dir = 6;
	name = "invincible railing";
	max_integrity = 1e+007
	},
/turf/open/floor/plating/beach/sand,
/area/library_floors/floor_language)
"Xg" = (
/obj/effect/turf_decal/trimline/red/filled/line{
	dir = 10
	},
/turf/open/indestructible/hotelwood,
/area/library_floors/floor_language)
"XD" = (
/obj/structure/table/wood,
/obj/item/lighter{
	pixel_y = 5;
	pixel_x = -8
	},
/turf/open/indestructible/hotelwood,
/area/library_floors/floor_language)
"XL" = (
/turf/open/space/basic,
/area/space)
"Yz" = (
/obj/structure/table/reinforced,
/obj/item/ego_weapon/city/liu/fist,
/turf/open/floor/mineral/plastitanium,
/area/library_floors/floor_language)
"YX" = (
/turf/open/floor/stone,
/area/library_floors/floor_language)
"ZO" = (
/obj/structure/window/reinforced/fulltile/indestructable,
/obj/structure/grille,
/turf/open/floor/mineral/plastitanium,
/area/library_floors/floor_language)
"ZQ" = (
/obj/item/toy/plush/binah,
/obj/item/reagent_containers/food/drinks/mug/tea{
	pixel_y = -6;
	pixel_x = 7
	},
/turf/open/floor/stone,
/area/library_floors/floor_language)

(1,1,1) = {"
XL
XL
XL
XL
XL
XL
XL
MR
Fo
MR
MR
MR
MR
MR
MR
MR
MR
Fo
MR
XL
XL
XL
XL
XL
"}
(2,1,1) = {"
XL
XL
XL
XL
XL
XL
XL
MR
vX
YX
YX
YX
YX
fp
YX
YX
YX
YX
MR
XL
XL
XL
XL
XL
"}
(3,1,1) = {"
XL
XL
XL
XL
MR
MR
Fo
MR
YX
Dt
UV
UV
UV
UV
UV
UV
aY
YX
MR
Fo
MR
MR
XL
XL
"}
(4,1,1) = {"
XL
XL
XL
XL
MR
Sw
jN
ZO
YX
wu
rn
PV
rn
rn
it
wP
Br
YX
ZO
jN
rv
MR
XL
XL
"}
(5,1,1) = {"
XL
XL
XL
XL
MR
JF
jN
ZO
YX
hL
rn
rn
ww
ww
rn
ry
zF
YX
ZO
jN
AF
MR
XL
XL
"}
(6,1,1) = {"
XL
XL
XL
XL
MR
vb
jN
ZO
YX
eI
rn
rn
ww
ww
rn
tK
Br
YX
ZO
jN
Yz
MR
XL
XL
"}
(7,1,1) = {"
XL
XL
XL
XL
MR
LT
jN
ZO
YX
hL
ED
rn
rn
rn
it
xB
zF
YX
ZO
jN
my
MR
XL
XL
"}
(8,1,1) = {"
XL
XL
XL
XL
MR
MR
Fo
MR
YX
hY
qz
qz
qz
qz
qz
qz
ib
YX
MR
Fo
MR
MR
XL
XL
"}
(9,1,1) = {"
XL
XL
XL
XL
XL
XL
XL
MR
rr
DP
YX
DP
YX
fp
DP
YX
DP
YX
MR
XL
XL
XL
XL
XL
"}
(10,1,1) = {"
XL
XL
XL
MR
MR
MR
MR
MR
MR
xb
MR
xb
MR
MR
xb
MR
xb
MR
MR
MR
MR
MR
MR
XL
"}
(11,1,1) = {"
XL
XL
XL
MR
AW
AW
AW
AW
El
we
YX
gU
Gb
Gb
we
YX
gU
ad
AW
AW
AW
AW
MR
XL
"}
(12,1,1) = {"
XL
XL
XL
MR
AW
AW
AW
AW
El
we
YX
gU
Gb
Gb
we
YX
gU
ad
AW
AW
AW
AW
MR
XL
"}
(13,1,1) = {"
XL
XL
XL
MR
AW
AW
AW
AW
El
we
YX
gU
Gb
Gb
we
YX
gU
ad
AW
AW
AW
AW
MR
XL
"}
(14,1,1) = {"
XL
XL
XL
MR
AW
yd
yd
AW
El
we
YX
gU
Gb
Gb
we
YX
gU
ad
AW
AW
AW
AW
MR
XL
"}
(15,1,1) = {"
XL
XL
XL
MR
AW
yd
yd
AW
El
we
YX
gU
Gb
Gb
we
YX
gU
ad
AW
AW
yd
AW
MR
XL
"}
(16,1,1) = {"
XL
XL
XL
MR
AW
AW
AW
AW
El
we
YX
gU
Gb
Bl
we
YX
gU
ad
AW
AW
AW
AW
MR
XL
"}
(17,1,1) = {"
XL
XL
XL
MR
AW
AW
AW
AW
El
we
YX
gU
Gb
Gb
we
YX
gU
ad
AW
AW
AW
AW
MR
XL
"}
(18,1,1) = {"
XL
XL
XL
MR
AW
AW
AW
AW
El
we
YX
gU
Gb
Gb
we
YX
gU
ad
AW
AW
AW
AW
MR
XL
"}
(19,1,1) = {"
XL
XL
XL
MR
AW
AW
AW
AW
El
we
YX
gU
Gb
Gb
we
YX
gU
ad
AW
AW
AW
AW
MR
XL
"}
(20,1,1) = {"
XL
XL
XL
MR
AW
AW
AW
AW
El
we
YX
gU
Gb
Gb
we
YX
gU
ad
AW
AW
yd
AW
MR
XL
"}
(21,1,1) = {"
XL
XL
XL
MR
AW
AW
AW
AW
El
we
YX
gU
Gb
Gb
we
YX
gU
ad
AW
yd
yd
AW
MR
XL
"}
(22,1,1) = {"
XL
XL
XL
MR
AW
yd
yd
AW
El
we
YX
gU
Gb
Gb
we
YX
gU
ad
AW
AW
AW
AW
MR
XL
"}
(23,1,1) = {"
XL
XL
XL
MR
AW
AW
yd
AW
El
we
YX
gU
Gb
Gb
we
YX
gU
ad
AW
AW
AW
AW
MR
XL
"}
(24,1,1) = {"
XL
XL
XL
MR
AW
AW
AW
AW
El
we
YX
gU
Gb
Gb
we
YX
gU
ad
AW
yd
yd
AW
MR
XL
"}
(25,1,1) = {"
XL
XL
XL
MR
AW
AW
AW
AW
El
we
YX
gU
Gb
Gb
we
YX
gU
ad
AW
yd
yd
AW
MR
XL
"}
(26,1,1) = {"
XL
XL
XL
MR
AW
AW
AW
AW
El
we
YX
gU
Gb
Gb
we
YX
gU
ad
AW
AW
yd
AW
MR
XL
"}
(27,1,1) = {"
XL
XL
XL
MR
AW
AW
AW
AW
El
we
YX
gU
Gb
Bl
we
YX
gU
ad
AW
AW
AW
AW
MR
XL
"}
(28,1,1) = {"
XL
XL
XL
MR
AW
yd
yd
AW
El
we
YX
gU
Gb
Gb
we
YX
gU
ad
AW
AW
AW
AW
MR
XL
"}
(29,1,1) = {"
XL
XL
XL
MR
AW
AW
yd
AW
El
we
YX
gU
Gb
Gb
we
YX
gU
ad
AW
AW
AW
AW
MR
XL
"}
(30,1,1) = {"
XL
XL
XL
MR
AW
AW
AW
AW
El
we
YX
gU
Gb
Gb
we
YX
gU
ad
AW
AW
AW
AW
MR
XL
"}
(31,1,1) = {"
XL
XL
XL
MR
AW
AW
AW
AW
El
we
YX
gU
Gb
Gb
we
YX
gU
ad
AW
AW
AW
AW
MR
XL
"}
(32,1,1) = {"
XL
XL
XL
MR
AW
AW
AW
AW
El
we
YX
gU
Gb
Gb
we
YX
gU
ad
AW
yd
AW
AW
MR
XL
"}
(33,1,1) = {"
XL
XL
XL
MR
AW
AW
AW
AW
El
we
YX
gU
Gb
Gb
we
YX
gU
ad
AW
yd
yd
AW
MR
XL
"}
(34,1,1) = {"
XL
XL
XL
MR
AW
AW
yd
AW
El
we
YX
gU
Gb
Gb
we
YX
gU
ad
AW
yd
yd
AW
MR
XL
"}
(35,1,1) = {"
XL
XL
XL
MR
AW
yd
yd
AW
El
we
YX
gU
Gb
Gb
we
YX
gU
ad
AW
AW
AW
AW
MR
XL
"}
(36,1,1) = {"
XL
XL
XL
MR
AW
AW
yd
AW
El
we
YX
gU
Gb
Gb
we
YX
gU
ad
AW
AW
AW
AW
MR
XL
"}
(37,1,1) = {"
XL
XL
XL
MR
AW
AW
AW
AW
El
we
YX
gU
Gb
Gb
we
YX
gU
ad
AW
AW
AW
AW
MR
XL
"}
(38,1,1) = {"
XL
XL
XL
MR
AW
AW
AW
AW
El
we
YX
gU
Gb
Gb
we
YX
gU
ad
AW
AW
AW
AW
MR
XL
"}
(39,1,1) = {"
XL
XL
XL
MR
AW
AW
AW
AW
El
we
YX
gU
Gb
Gb
we
YX
gU
ad
AW
AW
AW
AW
MR
XL
"}
(40,1,1) = {"
XL
XL
XL
MR
AW
AW
AW
AW
El
we
YX
gU
Gb
Gb
we
YX
gU
ad
AW
AW
AW
AW
MR
XL
"}
(41,1,1) = {"
XL
XL
XL
MR
AW
yd
yd
AW
El
we
YX
gU
Gb
Gb
we
YX
gU
ad
AW
yd
yd
AW
MR
XL
"}
(42,1,1) = {"
XL
XL
XL
MR
AW
yd
yd
AW
El
we
YX
gU
Gb
Gb
we
YX
gU
ad
AW
yd
AW
AW
MR
XL
"}
(43,1,1) = {"
XL
XL
XL
MR
AW
yd
yd
AW
El
we
YX
gU
Gb
Bl
we
YX
gU
ad
AW
AW
AW
AW
MR
XL
"}
(44,1,1) = {"
XL
XL
XL
MR
AW
AW
AW
AW
El
we
YX
gU
Gb
Gb
we
YX
gU
ad
AW
AW
AW
AW
MR
XL
"}
(45,1,1) = {"
XL
XL
XL
MR
AW
AW
AW
AW
El
we
YX
gU
Gb
Gb
we
YX
gU
ad
AW
AW
AW
AW
MR
XL
"}
(46,1,1) = {"
XL
XL
XL
MR
AW
AW
AW
AW
El
we
YX
gU
Gb
Gb
we
YX
gU
ad
AW
AW
AW
AW
MR
XL
"}
(47,1,1) = {"
XL
XL
XL
MR
AW
AW
AW
AW
El
we
YX
gU
Gb
Gb
we
YX
gU
ad
AW
AW
AW
AW
MR
XL
"}
(48,1,1) = {"
XL
XL
XL
MR
AW
AW
AW
AW
El
we
YX
gU
Gb
Gb
we
YX
gU
ad
AW
AW
AW
AW
MR
XL
"}
(49,1,1) = {"
XL
XL
XL
MR
MR
MR
MR
MR
MR
xb
MR
xb
MR
MR
xb
MR
xb
MR
MR
MR
MR
MR
MR
XL
"}
(50,1,1) = {"
XL
XL
XL
XL
XL
XL
XL
Mp
YX
ei
YX
ei
YX
YX
ei
YX
ei
YX
Mp
XL
XL
XL
XL
XL
"}
(51,1,1) = {"
XL
XL
XL
XL
XL
XL
XL
Mp
YX
Dt
UV
UV
UV
Ur
UV
UV
Xg
YX
Mp
XL
XL
XL
XL
XL
"}
(52,1,1) = {"
XL
XL
XL
MR
MR
MR
MR
MR
YX
hL
ON
Ox
EB
EB
Ox
Ov
zF
YX
MR
MR
MR
MR
MR
XL
"}
(53,1,1) = {"
XL
XL
XL
MR
GT
ZQ
rW
uL
YX
hL
cw
HC
EB
ja
Qd
pz
zF
YX
ED
EU
ED
Rm
MR
XL
"}
(54,1,1) = {"
XL
XL
XL
MR
Di
Jq
ou
uL
YX
hL
yq
EB
EB
EB
EB
EB
zF
YX
rn
xB
wP
XD
MR
XL
"}
(55,1,1) = {"
XL
XL
XL
MR
YX
GM
ss
uL
YX
hL
EB
EB
EB
lP
EB
EB
zF
YX
rn
wP
Gd
xB
MR
XL
"}
(56,1,1) = {"
XL
XL
XL
MR
ss
YX
IM
uL
YX
hL
cw
kV
EB
ja
Qd
pz
zF
YX
rn
TW
rn
Sf
MR
XL
"}
(57,1,1) = {"
XL
XL
XL
MR
MR
MR
MR
MR
YX
hL
HM
hT
EB
EB
hT
VQ
zF
YX
MR
MR
MR
MR
MR
XL
"}
(58,1,1) = {"
XL
XL
XL
XL
XL
XL
XL
Mp
YX
sO
qz
qz
qz
qz
qz
qz
ib
YX
Mp
XL
XL
XL
XL
XL
"}
(59,1,1) = {"
XL
XL
XL
XL
XL
XL
XL
Mp
YX
YX
YX
YX
YX
YX
YX
YX
YX
YX
Mp
XL
XL
XL
XL
XL
"}
(60,1,1) = {"
XL
XL
XL
XL
XL
XL
XL
MR
MR
MR
MR
MR
MR
MR
MR
MR
MR
MR
MR
XL
XL
XL
XL
XL
"}
