//MAP CONVERTED BY dmm2tgm.py THIS HEADER COMMENT PREVENTS RECONVERSION, DO NOT REMOVE
"ai" = (
/obj/structure/table/wood/fancy/orange,
/obj/item/ego_weapon/city/bladelineage,
/obj/effect/decal/cleanable/blood/drip,
/turf/open/floor/wood,
/area/library_floors/floor_history)
"av" = (
/obj/structure/easel,
/obj/item/canvas,
/turf/open/floor/plating/dirt/jungle/wasteland,
/area/library_floors/floor_history)
"aN" = (
/obj/effect/decal/cleanable/blood/tracks,
/obj/effect/decal/cleanable/blood/gibs/old,
/turf/open/floor/wood,
/area/library_floors/floor_history)
"bf" = (
/obj/structure/table/wood,
/obj/effect/turf_decal/siding/wood/corner{
	dir = 4
	},
/turf/open/indestructible/hotelwood,
/area/library_floors/floor_history)
"bK" = (
/obj/structure/alien/resin/wall/creature,
/turf/open/space/basic,
/area/library_floors/floor_history)
"cf" = (
/obj/machinery/door/airlock/wood,
/turf/open/indestructible/hotelwood,
/area/library_floors/floor_history)
"ct" = (
/obj/item/canvas,
/turf/open/floor/plating/dirt/jungle/wasteland,
/area/library_floors/floor_history)
"dG" = (
/obj/structure/bookcase/random/fiction,
/turf/closed/indestructible/wood,
/area/library_floors/floor_history)
"dI" = (
/turf/closed/indestructible/wood,
/area/library_floors/floor_history)
"eB" = (
/obj/structure/sink{
	dir = 8;
	pixel_x = 14;
	pixel_y = 2
	},
/turf/open/indestructible/hotelwood,
/area/library_floors/floor_history)
"eH" = (
/obj/structure/window/reinforced/fulltile/indestructable,
/turf/open/floor/pod/dark,
/area/library_floors/floor_history)
"eV" = (
/turf/open/floor/plating/dirt/jungle/wasteland,
/area/library_floors/floor_history)
"fP" = (
/obj/structure/chair/wood{
	dir = 4
	},
/obj/item/toy/plush/hod,
/turf/open/floor/wood,
/area/library_floors/floor_history)
"fQ" = (
/obj/effect/turf_decal/siding/wood/corner{
	dir = 4
	},
/obj/effect/turf_decal/siding/wood/corner{
	dir = 2
	},
/obj/effect/light_emitter{
	light_power = 4;
	light_range = 30;
	set_cap = 3;
	set_luminosity = 24
	},
/turf/open/indestructible/hotelwood,
/area/library_floors/floor_history)
"gc" = (
/obj/structure/table/wood/fancy/orange,
/obj/item/book/random,
/obj/effect/light_emitter{
	light_power = 4;
	light_range = 30;
	set_cap = 3;
	set_luminosity = 24
	},
/turf/open/floor/wood,
/area/library_floors/floor_history)
"gg" = (
/obj/effect/turf_decal/siding/wood/corner,
/obj/effect/turf_decal/siding/wood/corner{
	dir = 8
	},
/obj/effect/light_emitter{
	light_power = 4;
	light_range = 30;
	set_cap = 3;
	set_luminosity = 24
	},
/turf/open/indestructible/hotelwood,
/area/library_floors/floor_history)
"hL" = (
/obj/effect/turf_decal/siding/wood{
	dir = 1
	},
/obj/effect/turf_decal/siding/wood/corner{
	dir = 1
	},
/turf/open/indestructible/hotelwood,
/area/library_floors/floor_history)
"iK" = (
/obj/effect/turf_decal/trimline/purple/filled/line{
	dir = 10
	},
/turf/open/floor/pod/dark,
/area/library_floors/floor_history)
"jc" = (
/obj/structure/table/wood,
/obj/item/book/random{
	pixel_x = -5
	},
/obj/effect/turf_decal/siding/wood/corner{
	dir = 2
	},
/turf/open/indestructible/hotelwood,
/area/library_floors/floor_history)
"jq" = (
/obj/effect/decal/cleanable/vomit,
/turf/open/floor/plating/dirt/jungle/wasteland,
/area/library_floors/floor_history)
"jI" = (
/obj/item/book,
/obj/item/book{
	pixel_y = 9;
	pixel_x = 5
	},
/obj/item/book{
	pixel_y = -4;
	pixel_x = -8
	},
/obj/item/book{
	pixel_y = -8;
	pixel_x = 8
	},
/obj/effect/decal/cleanable/vomit,
/obj/effect/light_emitter{
	light_power = 4;
	light_range = 30;
	set_cap = 3;
	set_luminosity = 24
	},
/turf/open/floor/plating/dirt/jungle/wasteland,
/area/library_floors/floor_history)
"jS" = (
/obj/machinery/computer/camera_advanced/abductor,
/obj/effect/turf_decal/trimline/purple/filled/line{
	dir = 9
	},
/turf/open/floor/pod/dark,
/area/library_floors/floor_history)
"ky" = (
/obj/structure/table/wood,
/obj/item/toy/plush/malkuth,
/obj/effect/turf_decal/siding/wood/corner{
	dir = 1
	},
/turf/open/indestructible/hotelwood,
/area/library_floors/floor_history)
"kN" = (
/obj/item/reagent_containers/food/drinks/beer{
	pixel_x = 11;
	pixel_y = -9
	},
/turf/open/floor/plating/dirt/jungle/wasteland,
/area/library_floors/floor_history)
"mv" = (
/obj/structure/table/wood/fancy/orange,
/obj/item/book/random{
	pixel_x = 7
	},
/turf/open/floor/wood,
/area/library_floors/floor_history)
"mP" = (
/obj/structure/table/wood,
/turf/open/indestructible/hotelwood,
/area/library_floors/floor_history)
"nt" = (
/obj/effect/turf_decal/siding/wood/corner{
	dir = 4
	},
/obj/structure/fireplace,
/turf/open/indestructible/hotelwood,
/area/library_floors/floor_history)
"nu" = (
/obj/structure/table/optable/abductor,
/obj/effect/turf_decal/trimline/purple/filled/line{
	dir = 5
	},
/turf/open/floor/pod/dark,
/area/library_floors/floor_history)
"nX" = (
/obj/effect/turf_decal/trimline/purple/filled/corner,
/turf/open/floor/pod/dark,
/area/library_floors/floor_history)
"pJ" = (
/obj/structure/table/wood,
/obj/item/book/random{
	pixel_y = 2;
	pixel_x = 7
	},
/turf/open/indestructible/hotelwood,
/area/library_floors/floor_history)
"pL" = (
/turf/open/floor/wood,
/area/library_floors/floor_history)
"pT" = (
/obj/item/book/random,
/obj/structure/displaycase/noalert,
/turf/open/indestructible/hotelwood,
/area/library_floors/floor_history)
"re" = (
/obj/effect/turf_decal/siding/wood{
	dir = 8
	},
/turf/open/indestructible/hotelwood,
/area/library_floors/floor_history)
"so" = (
/obj/effect/turf_decal/siding/wood{
	dir = 8
	},
/obj/effect/turf_decal/siding/wood/corner{
	dir = 1
	},
/obj/structure/fireplace,
/turf/open/indestructible/hotelwood,
/area/library_floors/floor_history)
"sN" = (
/obj/effect/turf_decal/siding/wood{
	dir = 1
	},
/obj/effect/turf_decal/siding/wood/corner{
	dir = 4
	},
/turf/open/indestructible/hotelwood,
/area/library_floors/floor_history)
"to" = (
/obj/item/canvas,
/obj/effect/decal/cleanable/vomit,
/turf/open/floor/plating/dirt/jungle/wasteland,
/area/library_floors/floor_history)
"tO" = (
/obj/effect/turf_decal/siding/wood/corner{
	dir = 8
	},
/obj/effect/turf_decal/siding/wood/corner{
	dir = 1
	},
/turf/open/indestructible/hotelwood,
/area/library_floors/floor_history)
"ui" = (
/obj/item/reagent_containers/food/drinks/beer{
	pixel_x = -10;
	pixel_y = -7
	},
/obj/item/book{
	pixel_y = 3;
	pixel_x = 23
	},
/turf/open/floor/plating/dirt/jungle/wasteland,
/area/library_floors/floor_history)
"uv" = (
/obj/effect/decal/cleanable/blood/drip,
/turf/open/floor/wood,
/area/library_floors/floor_history)
"vm" = (
/obj/structure/closet/abductor,
/obj/item/slimepotion/speed,
/obj/effect/turf_decal/trimline/purple/filled/line{
	dir = 1
	},
/turf/open/floor/pod/dark,
/area/library_floors/floor_history)
"vT" = (
/obj/structure/table/wood/fancy/orange,
/obj/item/book/codex_gigas{
	pixel_y = 5;
	pixel_x = -4
	},
/turf/open/floor/wood,
/area/library_floors/floor_history)
"wV" = (
/obj/effect/turf_decal/siding/wood/corner{
	dir = 4
	},
/turf/open/indestructible/hotelwood,
/area/library_floors/floor_history)
"wW" = (
/obj/effect/light_emitter{
	light_power = 4;
	light_range = 30;
	set_cap = 3;
	set_luminosity = 24
	},
/turf/open/space/basic,
/area/space)
"wY" = (
/obj/effect/turf_decal/siding/wood/corner{
	dir = 4
	},
/obj/effect/light_emitter{
	light_power = 4;
	light_range = 30;
	set_cap = 3;
	set_luminosity = 24
	},
/turf/open/indestructible/hotelwood,
/area/library_floors/floor_history)
"xg" = (
/obj/structure/window/reinforced/fulltile/indestructable,
/turf/open/indestructible/hotelwood,
/area/library_floors/floor_history)
"xi" = (
/turf/open/space/basic,
/area/space)
"yk" = (
/obj/effect/turf_decal/siding/wood/corner{
	dir = 4
	},
/obj/effect/turf_decal/siding/wood/corner{
	dir = 2
	},
/turf/open/indestructible/hotelwood,
/area/library_floors/floor_history)
"yW" = (
/obj/effect/turf_decal/siding/wood/corner{
	dir = 4
	},
/obj/effect/turf_decal/siding/wood/corner{
	dir = 1
	},
/obj/effect/light_emitter{
	light_power = 4;
	light_range = 30;
	set_cap = 3;
	set_luminosity = 24
	},
/turf/open/indestructible/hotelwood,
/area/library_floors/floor_history)
"zK" = (
/obj/effect/turf_decal/siding/wood,
/obj/effect/turf_decal/siding/wood,
/turf/open/indestructible/hotelwood,
/area/library_floors/floor_history)
"zT" = (
/obj/machinery/abductor/pad,
/obj/effect/turf_decal/trimline/purple/filled/line,
/turf/open/floor/pod/dark,
/area/library_floors/floor_history)
"Ai" = (
/obj/structure/fireplace,
/turf/open/indestructible/hotelwood,
/area/library_floors/floor_history)
"AA" = (
/obj/effect/turf_decal/siding/wood{
	dir = 1
	},
/obj/structure/fireplace,
/turf/open/indestructible/hotelwood,
/area/library_floors/floor_history)
"AC" = (
/obj/effect/turf_decal/siding/wood/corner{
	dir = 8
	},
/turf/open/indestructible/hotelwood,
/area/library_floors/floor_history)
"Cn" = (
/obj/structure/falsewall/plastitanium,
/turf/open/space/basic,
/area/library_floors/floor_history)
"Cs" = (
/obj/structure/chair/wood{
	dir = 4
	},
/obj/effect/turf_decal/siding/wood{
	dir = 1
	},
/turf/open/indestructible/hotelwood,
/area/library_floors/floor_history)
"Cx" = (
/obj/item/canvas,
/obj/item/reagent_containers/pill/maintenance,
/turf/open/floor/plating/dirt/jungle/wasteland,
/area/library_floors/floor_history)
"CM" = (
/obj/structure/chair/wood{
	dir = 4
	},
/obj/effect/turf_decal/siding/wood,
/turf/open/indestructible/hotelwood,
/area/library_floors/floor_history)
"EY" = (
/obj/item/mop,
/obj/structure/mopbucket,
/obj/effect/turf_decal/siding/wood/corner{
	dir = 2
	},
/turf/open/indestructible/hotelwood,
/area/library_floors/floor_history)
"Fc" = (
/obj/structure/chair/wood{
	dir = 1
	},
/obj/item/toy/plush/bongbong,
/turf/open/floor/wood,
/area/library_floors/floor_history)
"FS" = (
/obj/effect/turf_decal/trimline/purple/filled/corner{
	dir = 8
	},
/turf/open/floor/pod/dark,
/area/library_floors/floor_history)
"FT" = (
/obj/structure/closet/abductor,
/obj/item/toy/plush/myo,
/obj/effect/turf_decal/trimline/purple/filled/line{
	dir = 1
	},
/turf/open/floor/pod/dark,
/area/library_floors/floor_history)
"Ht" = (
/obj/effect/turf_decal/siding/wood{
	dir = 4
	},
/turf/open/indestructible/hotelwood,
/area/library_floors/floor_history)
"Hx" = (
/obj/effect/turf_decal/siding/wood{
	dir = 1
	},
/obj/effect/turf_decal/siding/wood,
/turf/open/indestructible/hotelwood,
/area/library_floors/floor_history)
"Il" = (
/obj/effect/turf_decal/siding/wood/corner{
	dir = 1
	},
/obj/structure/fireplace,
/turf/open/indestructible/hotelwood,
/area/library_floors/floor_history)
"In" = (
/obj/effect/turf_decal/siding/wood{
	dir = 1
	},
/turf/open/indestructible/hotelwood,
/area/library_floors/floor_history)
"IM" = (
/obj/structure/table/wood,
/obj/machinery/chem_dispenser/drinks/beer,
/turf/open/floor/plating/dirt/jungle/wasteland,
/area/library_floors/floor_history)
"IW" = (
/obj/effect/turf_decal/siding/wood,
/obj/effect/turf_decal/siding/wood{
	dir = 1
	},
/turf/open/indestructible/hotelwood,
/area/library_floors/floor_history)
"IZ" = (
/obj/item/toy/plush/yesod,
/obj/item/gun/ego_gun/pistol/solemnlament{
	pixel_y = -7;
	pixel_x = -13
	},
/obj/item/gun/ego_gun/pistol/solemnvow{
	pixel_x = 18;
	pixel_y = -7
	},
/obj/effect/turf_decal/trimline/purple/filled/line{
	dir = 1
	},
/turf/open/floor/pod/dark,
/area/library_floors/floor_history)
"Jz" = (
/obj/structure/chair/wood{
	dir = 8
	},
/obj/item/toy/plush/yuri,
/turf/open/floor/wood,
/area/library_floors/floor_history)
"JZ" = (
/obj/effect/turf_decal/siding/wood/corner{
	dir = 1
	},
/turf/open/indestructible/hotelwood,
/area/library_floors/floor_history)
"Lk" = (
/obj/item/reagent_containers/pill/maintenance,
/turf/open/floor/plating/dirt/jungle/wasteland,
/area/library_floors/floor_history)
"Lx" = (
/obj/structure/displaycase,
/obj/item/flashlight/lantern,
/turf/open/floor/wood,
/area/library_floors/floor_history)
"LE" = (
/obj/effect/light_emitter{
	light_power = 4;
	light_range = 30;
	set_cap = 3;
	set_luminosity = 24
	},
/turf/open/indestructible/hotelwood,
/area/library_floors/floor_history)
"LU" = (
/obj/effect/light_emitter{
	light_power = 4;
	light_range = 30;
	set_cap = 3;
	set_luminosity = 24
	},
/turf/open/floor/pod/dark,
/area/library_floors/floor_history)
"NZ" = (
/obj/structure/chair/wood{
	dir = 8
	},
/turf/open/indestructible/hotelwood,
/area/library_floors/floor_history)
"Oy" = (
/obj/structure/window/reinforced/fulltile/indestructable,
/turf/open/floor/plating/dirt/jungle/wasteland,
/area/library_floors/floor_history)
"OW" = (
/obj/structure/bookcase/random/nonfiction,
/turf/closed/indestructible/wood,
/area/library_floors/floor_history)
"Pf" = (
/obj/structure/table/wood,
/obj/item/book/random{
	pixel_x = -3
	},
/turf/open/indestructible/hotelwood,
/area/library_floors/floor_history)
"Qo" = (
/obj/item/book/random,
/obj/item/book/random{
	pixel_y = 2
	},
/obj/item/book/random{
	pixel_y = 2;
	pixel_x = 7
	},
/obj/item/book/random{
	pixel_x = -5
	},
/obj/item/book/random{
	pixel_x = 7
	},
/obj/effect/turf_decal/siding/wood,
/turf/open/indestructible/hotelwood,
/area/library_floors/floor_history)
"RS" = (
/obj/structure/table/wood,
/obj/item/book/random,
/turf/open/indestructible/hotelwood,
/area/library_floors/floor_history)
"Su" = (
/turf/open/indestructible/hotelwood,
/area/library_floors/floor_history)
"Sx" = (
/obj/item/book/random,
/obj/item/book/random{
	pixel_y = 2
	},
/obj/item/book/random{
	pixel_y = 2;
	pixel_x = 7
	},
/obj/item/book/random{
	pixel_x = -5
	},
/obj/item/book/random{
	pixel_x = 7
	},
/obj/structure/table/wood,
/turf/open/indestructible/hotelwood,
/area/library_floors/floor_history)
"Sy" = (
/obj/effect/turf_decal/siding/wood{
	dir = 4
	},
/obj/effect/turf_decal/siding/wood/corner{
	dir = 4
	},
/obj/structure/fireplace,
/turf/open/indestructible/hotelwood,
/area/library_floors/floor_history)
"SX" = (
/obj/effect/turf_decal/siding/wood{
	dir = 8
	},
/obj/effect/turf_decal/siding/wood{
	dir = 4
	},
/turf/open/indestructible/hotelwood,
/area/library_floors/floor_history)
"Tf" = (
/obj/effect/turf_decal/trimline/purple/filled/line{
	dir = 6
	},
/turf/open/floor/pod/dark,
/area/library_floors/floor_history)
"TX" = (
/obj/effect/decal/cleanable/blood,
/turf/open/floor/wood,
/area/library_floors/floor_history)
"Vp" = (
/obj/structure/chair/wood{
	dir = 4
	},
/turf/open/indestructible/hotelwood,
/area/library_floors/floor_history)
"WC" = (
/obj/effect/turf_decal/siding/wood/corner{
	dir = 2
	},
/turf/open/indestructible/hotelwood,
/area/library_floors/floor_history)
"Xn" = (
/obj/effect/turf_decal/siding/wood,
/turf/open/indestructible/hotelwood,
/area/library_floors/floor_history)
"XO" = (
/obj/structure/table/wood,
/obj/item/toy/plush/scorched,
/obj/effect/turf_decal/siding/wood/corner{
	dir = 8
	},
/turf/open/indestructible/hotelwood,
/area/library_floors/floor_history)
"Zg" = (
/obj/structure/bookcase/random/nonfiction,
/turf/open/indestructible/hotelwood,
/area/library_floors/floor_history)
"ZB" = (
/obj/effect/decal/cleanable/blood/footprints,
/turf/open/floor/wood,
/area/library_floors/floor_history)
"ZW" = (
/obj/structure/table/wood,
/obj/item/gun/ego_gun/city/thumb/weak,
/obj/item/toy/plush/netzach,
/obj/item/reagent_containers/food/drinks/beer{
	pixel_x = -9
	},
/obj/item/reagent_containers/food/drinks/beer{
	pixel_x = 11;
	pixel_y = -9
	},
/turf/open/floor/plating/dirt/jungle/wasteland,
/area/library_floors/floor_history)

(1,1,1) = {"
xi
xi
xi
xi
xi
xi
xi
xi
dI
dI
dI
dI
dI
dI
dI
dI
dI
dI
dI
dI
xi
xi
xi
xi
"}
(2,1,1) = {"
xi
xi
xi
xi
xi
xi
xi
xi
dI
Zg
In
Su
RS
mP
Su
mP
RS
Xn
Zg
dI
xi
xi
xi
xi
"}
(3,1,1) = {"
xi
xi
xi
xi
xi
xi
xi
xi
dI
re
JZ
Su
NZ
NZ
Su
NZ
NZ
AC
re
dI
xi
xi
xi
xi
"}
(4,1,1) = {"
xi
xi
xi
xi
xi
xi
xi
xi
dI
Sy
wY
WC
Ht
Ht
yk
Ht
Ht
fQ
Ht
dI
xi
xi
xi
xi
"}
(5,1,1) = {"
xi
xi
xi
xi
xi
xi
xi
xi
dI
Zg
In
Xn
Zg
Zg
IW
Zg
Zg
Hx
Zg
dI
xi
xi
xi
xi
"}
(6,1,1) = {"
xi
xi
xi
xi
xi
xi
xi
xi
dI
Zg
In
Xn
Zg
Zg
IW
Zg
Zg
Hx
Zg
dI
xi
xi
xi
xi
"}
(7,1,1) = {"
xi
xi
xi
xi
wW
xi
xi
xi
dI
so
JZ
AC
re
re
tO
re
re
tO
re
dI
xi
xi
xi
xi
"}
(8,1,1) = {"
xi
xi
xi
xi
xi
xi
xi
xi
dI
Ht
wV
WC
Ht
Ht
yk
Ht
Ht
yk
Ht
dI
xi
xi
xi
xi
"}
(9,1,1) = {"
xi
xi
xi
xi
xi
xi
xi
xi
dI
Zg
In
Xn
Zg
Zg
IW
Zg
Zg
IW
Zg
dI
xi
xi
xi
xi
"}
(10,1,1) = {"
xi
xi
xi
xi
dI
dI
dI
dI
dI
dI
dI
cf
dI
dI
dI
dI
dI
cf
dI
dI
dI
dI
dI
dI
"}
(11,1,1) = {"
xi
xi
xi
xi
OW
In
Xn
Su
Su
Xn
Su
Su
Xn
Su
Su
Xn
Su
Su
Xn
Su
Su
Xn
Xn
OW
"}
(12,1,1) = {"
xi
xi
xi
xi
OW
In
Xn
Su
Su
Xn
Su
Su
Xn
Su
Su
Xn
Su
Su
Xn
Su
Su
Xn
Xn
OW
"}
(13,1,1) = {"
Cn
Cn
Cn
Cn
dI
Su
Xn
Su
Su
Xn
Su
Su
Xn
Su
pT
Xn
Su
Su
Xn
Su
Su
Xn
Su
dI
"}
(14,1,1) = {"
Cn
jS
iK
Cn
dI
nt
Xn
Su
Su
Xn
Su
Su
Xn
Su
Su
Xn
Su
Su
Xn
Su
Su
Xn
Su
dI
"}
(15,1,1) = {"
Cn
FT
FS
iK
eH
In
Xn
Su
pT
Xn
Su
Su
Xn
Su
Su
Xn
Su
Su
zK
Su
pT
Xn
Su
dI
"}
(16,1,1) = {"
Cn
IZ
LU
zT
eH
In
Xn
Su
Su
Xn
Su
Su
Xn
Su
Su
Xn
Su
Su
Xn
Su
Su
Xn
Su
dI
"}
(17,1,1) = {"
Cn
vm
nX
Tf
eH
In
Xn
Su
Su
Xn
Su
Su
Xn
Su
LE
Xn
Su
Su
Xn
Su
Su
Xn
Su
dI
"}
(18,1,1) = {"
Cn
nu
Tf
Cn
dI
Il
Xn
Su
Su
Xn
Su
pT
Xn
Su
Su
Xn
Su
Su
Xn
Su
Su
Xn
Su
dI
"}
(19,1,1) = {"
Cn
Cn
Cn
Cn
dI
Su
Xn
Su
Su
Xn
Su
Su
Xn
Su
Su
Xn
Su
pT
Xn
Su
Su
Xn
pT
dI
"}
(20,1,1) = {"
xi
xi
xi
xi
dI
Su
Xn
Su
Su
Xn
Su
Su
Xn
Su
Su
Xn
Su
Su
Xn
Su
Su
Xn
Su
dI
"}
(21,1,1) = {"
xi
xi
xi
xi
dI
pT
Xn
Su
Su
Xn
Su
Su
Xn
Su
Su
Xn
Su
Su
Xn
Su
Su
Xn
Su
dI
"}
(22,1,1) = {"
xi
xi
xi
xi
dI
Su
Xn
Su
Su
Xn
Su
Su
Xn
Su
Su
Xn
Su
Su
Xn
Su
Su
Xn
Su
dI
"}
(23,1,1) = {"
xi
xi
xi
xi
dI
Su
Xn
Su
Su
Xn
Su
pT
Xn
Su
Su
Xn
Su
Su
Xn
Su
Su
Xn
Su
dI
"}
(24,1,1) = {"
xi
xi
xi
xi
dI
Su
Xn
Su
Su
Xn
Su
Su
zK
Su
Su
Xn
Su
pT
Xn
Su
Su
Xn
Su
dI
"}
(25,1,1) = {"
xi
xi
xi
xi
dI
Su
Xn
Su
Su
Xn
Su
Su
Xn
Su
Su
Xn
Su
Su
Xn
Su
Su
Xn
Su
dI
"}
(26,1,1) = {"
dI
dI
dI
dI
dI
wV
Xn
Su
Su
Xn
Su
Su
Xn
Su
Su
Xn
Su
Su
Xn
Su
Su
Xn
Su
dI
"}
(27,1,1) = {"
dG
TX
Lx
dI
dI
AA
Xn
Su
pT
Xn
Su
Su
Xn
Su
pT
Xn
Su
Su
Xn
Su
pT
Xn
Su
dI
"}
(28,1,1) = {"
dG
fP
aN
TX
xg
In
Xn
Su
Su
Xn
Su
Su
Xn
Su
Su
Xn
Su
Su
Xn
Su
Su
Xn
Su
dI
"}
(29,1,1) = {"
dI
vT
ai
pL
xg
In
Xn
Su
Su
Xn
Su
Su
Xn
Su
LE
Xn
Su
Su
Xn
Su
Su
Xn
Su
dI
"}
(30,1,1) = {"
dI
mv
gc
Fc
xg
In
Xn
Su
Su
Xn
Su
Su
Xn
Su
Su
Xn
Su
Su
Xn
Su
Su
Xn
Su
dI
"}
(31,1,1) = {"
dG
Jz
ZB
uv
xg
In
Xn
Su
Su
Xn
Su
Su
Xn
Su
Su
Xn
Su
pT
Xn
Su
Su
Xn
Su
dI
"}
(32,1,1) = {"
dG
TX
Lx
dI
dI
AA
Xn
Su
Su
Xn
Su
Su
Xn
Su
Su
Xn
Su
Su
Xn
Su
Su
Xn
Su
dI
"}
(33,1,1) = {"
dI
dI
dI
dI
dI
JZ
Xn
Su
Su
Xn
Su
pT
Xn
Su
Su
Xn
Su
Su
Xn
Su
Su
Xn
Su
dI
"}
(34,1,1) = {"
xi
xi
xi
xi
dI
Su
Xn
Su
Su
Xn
Su
Su
Xn
Su
Su
Xn
Su
Su
Xn
Su
Su
Xn
Su
dI
"}
(35,1,1) = {"
xi
xi
xi
xi
dI
Su
Xn
Su
pT
Xn
Su
Su
Xn
Su
Su
Xn
Su
Su
Xn
Su
Su
Xn
Su
dI
"}
(36,1,1) = {"
xi
xi
xi
xi
dI
Su
Xn
Su
Su
Xn
Su
Su
Xn
Su
Su
Xn
Su
Su
Xn
Su
pT
Xn
Su
dI
"}
(37,1,1) = {"
xi
xi
xi
xi
dI
pT
Xn
Su
Su
Xn
Su
Su
Xn
Su
Su
Xn
Su
Su
Xn
Su
Su
Xn
pT
dI
"}
(38,1,1) = {"
xi
xi
xi
xi
dI
Su
Xn
Su
Su
Xn
Su
Su
Xn
Su
Su
Xn
Su
pT
Xn
Su
Su
Xn
Su
dI
"}
(39,1,1) = {"
xi
xi
xi
xi
dI
Su
Xn
Su
Su
Xn
Su
Su
Xn
Su
Su
Xn
Su
Su
Xn
Su
Su
Xn
Su
dI
"}
(40,1,1) = {"
bK
bK
bK
bK
dI
Su
Xn
Su
pT
Xn
Su
Su
Xn
Su
Su
Xn
Su
Su
Xn
Su
Su
Xn
Su
dI
"}
(41,1,1) = {"
bK
Cx
ct
bK
dI
Ai
Xn
Su
Su
Xn
Su
pT
Xn
Su
Su
Xn
Su
Su
Xn
Su
Su
Xn
Su
dI
"}
(42,1,1) = {"
bK
av
ui
to
Oy
wV
Xn
Su
Su
Xn
Su
Su
Xn
Su
LE
Xn
Su
Su
Xn
Su
pT
Xn
Su
dI
"}
(43,1,1) = {"
bK
IM
jI
kN
Oy
In
Xn
Su
Su
Xn
Su
Su
Xn
Su
Su
Xn
Su
Su
Xn
Su
Su
Xn
Su
dI
"}
(44,1,1) = {"
bK
ZW
jq
Lk
Oy
In
Xn
Su
pT
Xn
Su
Su
Xn
Su
Su
Xn
Su
Su
Xn
Su
Su
Xn
Su
dI
"}
(45,1,1) = {"
bK
Lk
eV
bK
dI
AA
zK
Su
Su
Xn
Su
Su
Xn
Su
pT
Xn
Su
pT
Xn
Su
Su
Xn
Su
dI
"}
(46,1,1) = {"
bK
bK
bK
bK
dI
JZ
Xn
Su
Su
Xn
Su
pT
Xn
Su
Su
Xn
Su
Su
Xn
Su
Su
Xn
Su
dI
"}
(47,1,1) = {"
xi
xi
xi
xi
OW
hL
Xn
Su
Su
Xn
Su
Su
Xn
Su
Su
Xn
Su
Su
Xn
Su
Su
Xn
Xn
OW
"}
(48,1,1) = {"
xi
xi
xi
xi
OW
sN
Xn
Su
Su
Xn
Su
Su
Xn
Su
Su
Xn
Su
Su
Xn
Su
Su
Xn
Xn
OW
"}
(49,1,1) = {"
xi
xi
xi
xi
dI
dI
dI
dI
dI
dI
dI
cf
dI
dI
dI
dI
dI
cf
dI
dI
dI
dI
dI
dI
"}
(50,1,1) = {"
xi
xi
xi
xi
xi
xi
xi
xi
dI
Sx
Su
Su
Vp
Vp
Su
Vp
Vp
Su
Sx
dI
xi
xi
xi
xi
"}
(51,1,1) = {"
xi
xi
xi
xi
xi
xi
xi
xi
dI
wV
Su
Su
Pf
mP
Su
mP
pJ
Su
WC
dI
xi
xi
xi
xi
"}
(52,1,1) = {"
xi
xi
xi
xi
xi
xi
xi
xi
OW
In
Su
Su
NZ
NZ
Su
NZ
NZ
Su
Xn
OW
xi
xi
xi
xi
"}
(53,1,1) = {"
xi
xi
xi
xi
xi
xi
xi
xi
OW
In
Su
WC
Ht
Ht
Ht
Ht
Ht
wV
Qo
OW
xi
xi
xi
xi
"}
(54,1,1) = {"
xi
xi
xi
xi
xi
xi
xi
xi
dI
Il
Su
Xn
Zg
Zg
Zg
Zg
Zg
In
AC
dI
xi
xi
xi
xi
"}
(55,1,1) = {"
xi
xi
xi
xi
xi
xi
xi
xi
dI
Sx
Su
gg
SX
SX
SX
SX
SX
yW
Su
dI
xi
xi
xi
xi
"}
(56,1,1) = {"
xi
xi
xi
xi
xi
xi
xi
xi
dI
nt
Su
Xn
Zg
Zg
Zg
Zg
Zg
In
WC
dI
xi
xi
xi
xi
"}
(57,1,1) = {"
xi
xi
xi
xi
xi
xi
xi
xi
OW
In
Su
AC
re
re
re
re
re
JZ
Xn
OW
xi
xi
xi
xi
"}
(58,1,1) = {"
xi
xi
xi
xi
xi
xi
xi
xi
OW
Cs
Su
Vp
Su
Su
Su
Su
Su
Vp
CM
OW
xi
xi
xi
xi
"}
(59,1,1) = {"
xi
xi
xi
xi
xi
xi
xi
xi
dI
ky
Su
jc
Ht
wV
eB
EY
Ht
bf
XO
dI
xi
xi
xi
xi
"}
(60,1,1) = {"
xi
xi
xi
xi
xi
xi
xi
xi
dI
dI
dI
dI
OW
dI
dI
dI
OW
dI
dI
dI
xi
xi
xi
xi
"}
