//MAP CONVERTED BY dmm2tgm.py THIS HEADER COMMENT PREVENTS RECONVERSION, DO NOT REMOVE
"ac" = (
/turf/open/floor/white{
	density = 1
	},
/area/library_floors/floor_naturalsci)
"cg" = (
/obj/structure/table/wood,
/obj/item/book/random,
/turf/open/indestructible/hotelwood,
/area/library_floors/floor_naturalsci)
"cJ" = (
/obj/structure/railing{
	dir = 5;
	max_integrity = 1e+007;
	name = "invincible railing"
	},
/turf/open/floor/carpet/lone,
/area/library_floors/floor_naturalsci)
"dl" = (
/obj/structure/railing{
	dir = 9;
	max_integrity = 1e+007;
	name = "invincible railing"
	},
/turf/open/floor/carpet/lone,
/area/library_floors/floor_naturalsci)
"eb" = (
/obj/structure/ladder/unbreakable{
	pixel_y = 8
	},
/turf/open/floor/carpet/red,
/area/library_floors/floor_naturalsci)
"ec" = (
/turf/open/floor/white{
	density = 1
	},
/area/space)
"ei" = (
/obj/structure/lattice,
/obj/structure/window/reinforced/fulltile/indestructable,
/turf/open/indestructible/hotelwood,
/area/library_floors/floor_naturalsci)
"fe" = (
/obj/item/toy/plush/kod,
/obj/item/ego_weapon/despair{
	pixel_x = 23;
	pixel_y = 4
	},
/obj/effect/light_emitter{
	light_power = 4;
	light_range = 30;
	set_cap = 3;
	set_luminosity = 24
	},
/turf/open/floor/facility/dark,
/area/library_floors/floor_naturalsci)
"fw" = (
/obj/structure/railing/corner{
	dir = 1
	},
/turf/open/floor/carpet/lone,
/area/library_floors/floor_naturalsci)
"fI" = (
/obj/item/flashlight/spotlight{
	light_color = "#d8b66f";
	light_range = 25
	},
/turf/open/floor/white{
	density = 1
	},
/area/library_floors/floor_naturalsci)
"id" = (
/obj/structure/chair/wood{
	dir = 8
	},
/turf/open/floor/carpet/lone,
/area/library_floors/floor_naturalsci)
"iE" = (
/obj/structure/railing/corner,
/turf/open/floor/mineral/gold,
/area/library_floors/floor_naturalsci)
"iK" = (
/obj/structure/altar_of_gods,
/turf/open/floor/carpet/red,
/area/library_floors/floor_naturalsci)
"lf" = (
/obj/item/toy/plush/nihil,
/turf/open/floor/facility/dark,
/area/library_floors/floor_naturalsci)
"lp" = (
/obj/structure/bookcase/random/nonfiction,
/turf/open/indestructible/hotelwood,
/area/library_floors/floor_naturalsci)
"lG" = (
/obj/structure/table/wood,
/obj/structure/table/wood,
/turf/open/floor/carpet/lone,
/area/library_floors/floor_naturalsci)
"nP" = (
/obj/structure/railing/corner{
	dir = 8;
	pixel_x = -1;
	pixel_y = 2
	},
/turf/open/floor/mineral/gold,
/area/library_floors/floor_naturalsci)
"px" = (
/turf/open/chasm,
/area/library_floors/floor_naturalsci)
"qj" = (
/obj/item/toy/plush/kog,
/obj/item/ego_weapon/goldrush{
	pixel_y = -15;
	pixel_x = 13
	},
/turf/open/floor/facility/dark,
/area/library_floors/floor_naturalsci)
"qk" = (
/obj/structure/railing/corner{
	dir = 4
	},
/turf/open/floor/carpet/lone,
/area/library_floors/floor_naturalsci)
"rJ" = (
/obj/effect/light_emitter{
	light_power = 4;
	light_range = 30;
	set_cap = 3;
	set_luminosity = 24
	},
/turf/open/floor/carpet/red,
/area/library_floors/floor_naturalsci)
"un" = (
/obj/item/toy/plush/sow,
/obj/item/ego_weapon/blind_rage{
	pixel_x = 7;
	pixel_y = -7
	},
/turf/open/floor/facility/dark,
/area/library_floors/floor_naturalsci)
"uH" = (
/turf/open/space/basic,
/area/space)
"vA" = (
/obj/structure/bookcase/random/nonfiction,
/turf/open/floor/carpet/red,
/area/library_floors/floor_naturalsci)
"wa" = (
/turf/open/floor/carpet/lone,
/area/library_floors/floor_naturalsci)
"wn" = (
/obj/structure/railing{
	dir = 10;
	max_integrity = 1e+007;
	name = "invincible railing"
	},
/turf/open/floor/mineral/gold,
/area/library_floors/floor_naturalsci)
"wz" = (
/obj/structure/railing,
/turf/open/indestructible/hotelwood,
/area/library_floors/floor_naturalsci)
"wN" = (
/obj/structure/window/bronze/fulltile,
/obj/structure/lattice,
/turf/open/floor/white{
	density = 1
	},
/area/library_floors/floor_naturalsci)
"wO" = (
/obj/item/candle/infinite,
/turf/closed/wall/mineral/gold,
/area/library_floors/floor_naturalsci)
"xd" = (
/obj/effect/light_emitter{
	light_power = 4;
	light_range = 30;
	set_cap = 3;
	set_luminosity = 24
	},
/turf/open/floor/carpet/lone,
/area/library_floors/floor_naturalsci)
"xx" = (
/obj/structure/railing{
	dir = 6;
	name = "invincible railing";
	max_integrity = 1e+007
	},
/turf/open/floor/mineral/gold,
/area/library_floors/floor_naturalsci)
"yJ" = (
/obj/structure/chair/wood/wings{
	pixel_y = 0;
	dir = 1
	},
/turf/open/indestructible/hotelwood,
/area/library_floors/floor_naturalsci)
"zj" = (
/obj/structure/displaycase/noalert,
/turf/open/floor/carpet/red,
/area/library_floors/floor_naturalsci)
"zq" = (
/obj/structure/railing/corner{
	dir = 4
	},
/turf/open/floor/mineral/gold,
/area/library_floors/floor_naturalsci)
"zP" = (
/obj/structure/table/wood/fancy,
/turf/open/floor/mineral/gold,
/area/library_floors/floor_naturalsci)
"BB" = (
/obj/structure/railing{
	name = "invincible railing";
	resistance_flags = 64;
	dir = 1
	},
/turf/open/floor/mineral/gold,
/area/library_floors/floor_naturalsci)
"BX" = (
/turf/open/floor/plating/ice{
	density = 1
	},
/area/library_floors/floor_naturalsci)
"Ch" = (
/obj/item/toy/plush/qoh,
/obj/item/gun/ego_gun/hatred{
	pixel_x = 9;
	pixel_y = 5
	},
/turf/open/floor/facility/dark,
/area/library_floors/floor_naturalsci)
"CA" = (
/obj/item/toy/plush/lisa,
/obj/structure/railing,
/turf/open/indestructible/hotelwood,
/area/library_floors/floor_naturalsci)
"EG" = (
/turf/open/floor/carpet/red,
/area/library_floors/floor_naturalsci)
"Gp" = (
/obj/structure/table/wood,
/turf/open/floor/carpet/lone,
/area/library_floors/floor_naturalsci)
"Jm" = (
/obj/structure/flora/icestalactite{
	pixel_y = -47
	},
/turf/open/floor/plating/ice{
	density = 1
	},
/area/library_floors/floor_naturalsci)
"Jz" = (
/turf/open/floor/facility/dark,
/area/library_floors/floor_naturalsci)
"JX" = (
/obj/structure/chair/wood{
	dir = 4
	},
/turf/open/floor/carpet/lone,
/area/library_floors/floor_naturalsci)
"Kd" = (
/obj/item/flashlight/spotlight{
	light_color = "#d8b66f";
	light_range = 25
	},
/turf/open/floor/white{
	density = 1
	},
/area/space)
"NE" = (
/obj/structure/flora/icestalactite{
	pixel_y = -48
	},
/turf/open/floor/plating/ice{
	density = 1
	},
/area/library_floors/floor_naturalsci)
"Od" = (
/obj/structure/railing{
	name = "invincible railing";
	resistance_flags = 64
	},
/turf/open/floor/mineral/gold,
/area/library_floors/floor_naturalsci)
"PZ" = (
/obj/structure/railing{
	dir = 8;
	max_integrity = 1e+007;
	name = "invincible railing"
	},
/turf/open/floor/carpet/lone,
/area/library_floors/floor_naturalsci)
"Qe" = (
/turf/open/lava{
	density = 1
	},
/area/library_floors/floor_naturalsci)
"QB" = (
/turf/closed/wall/mineral/gold,
/area/library_floors/floor_naturalsci)
"QK" = (
/obj/structure/table/wood,
/obj/item/book/random,
/turf/open/floor/carpet/lone,
/area/library_floors/floor_naturalsci)
"Rt" = (
/obj/item/flashlight/spotlight{
	light_color = "#d8b66f";
	light_range = 25
	},
/turf/open/chasm,
/area/library_floors/floor_naturalsci)
"Rw" = (
/obj/structure/flora/icestalactite/small{
	pixel_y = -45
	},
/turf/open/floor/plating/ice{
	density = 1
	},
/area/library_floors/floor_naturalsci)
"Sq" = (
/obj/structure/railing/corner,
/obj/structure/railing/corner{
	dir = 8
	},
/turf/open/indestructible/hotelwood,
/area/library_floors/floor_naturalsci)
"SI" = (
/obj/structure/altar_of_gods,
/obj/structure/flora/iceslab/alt{
	pixel_y = 14
	},
/turf/open/floor/mineral/gold,
/area/library_floors/floor_naturalsci)
"Tc" = (
/obj/structure/altar_of_gods,
/obj/structure/flora/tree/dead,
/turf/open/floor/mineral/gold,
/area/library_floors/floor_naturalsci)
"TL" = (
/obj/structure/table/wood/fancy,
/obj/item/candle/infinite{
	pixel_y = 5;
	pixel_x = 16
	},
/turf/open/floor/mineral/gold,
/area/library_floors/floor_naturalsci)
"UJ" = (
/turf/open/indestructible/hotelwood,
/area/library_floors/floor_naturalsci)
"WW" = (
/obj/structure/railing{
	dir = 4;
	name = "invincible railing";
	max_integrity = 1e+007
	},
/turf/open/floor/carpet/lone,
/area/library_floors/floor_naturalsci)
"Xk" = (
/obj/structure/railing{
	dir = 1;
	name = "invincible railing";
	resistance_flags = 64
	},
/turf/open/floor/carpet/lone,
/area/library_floors/floor_naturalsci)
"Yy" = (
/obj/structure/table/wood,
/turf/open/indestructible/hotelwood,
/area/library_floors/floor_naturalsci)
"Zb" = (
/obj/structure/railing/corner{
	dir = 1
	},
/turf/open/floor/mineral/gold,
/area/library_floors/floor_naturalsci)
"Zm" = (
/obj/machinery/door/airlock/wood/glass,
/turf/open/floor/carpet/red,
/area/library_floors/floor_naturalsci)
"Zw" = (
/turf/open/floor/mineral/gold,
/area/library_floors/floor_naturalsci)

(1,1,1) = {"
uH
uH
uH
uH
uH
uH
uH
QB
QB
QB
QB
QB
QB
QB
QB
QB
QB
QB
QB
uH
uH
uH
uH
uH
"}
(2,1,1) = {"
uH
uH
uH
uH
ec
ec
ec
QB
Yy
UJ
EG
wa
wa
wa
wa
EG
UJ
lp
QB
uH
uH
uH
uH
uH
"}
(3,1,1) = {"
uH
uH
uH
ec
ec
ec
ec
QB
cg
UJ
EG
wa
wa
wa
wa
EG
UJ
lp
QB
QB
QB
QB
QB
uH
"}
(4,1,1) = {"
uH
ec
ec
ec
ec
QB
QB
QB
EG
EG
zj
wa
wa
wa
wa
EG
UJ
lp
QB
un
Jz
Ch
QB
uH
"}
(5,1,1) = {"
uH
ec
ec
ec
ec
wN
Yy
yJ
wa
wa
wa
wa
xd
wa
wa
EG
UJ
UJ
ei
Jz
fe
Jz
QB
uH
"}
(6,1,1) = {"
uH
ec
ec
Kd
ec
wN
Yy
UJ
wa
wa
wa
wa
wa
wa
wa
EG
UJ
UJ
ei
Jz
qj
Jz
QB
uH
"}
(7,1,1) = {"
uH
ec
ec
ec
ec
QB
QB
QB
EG
EG
zj
wa
wa
wa
wa
EG
UJ
lp
QB
Jz
lf
Jz
QB
uH
"}
(8,1,1) = {"
uH
uH
uH
ec
ec
ac
ac
QB
Yy
UJ
EG
wa
wa
wa
wa
EG
UJ
lp
QB
QB
QB
QB
QB
uH
"}
(9,1,1) = {"
uH
uH
uH
uH
ec
ec
ec
QB
cg
UJ
EG
wa
wa
wa
wa
EG
UJ
lp
QB
uH
uH
uH
uH
uH
"}
(10,1,1) = {"
uH
uH
uH
QB
QB
QB
QB
QB
QB
QB
QB
Zm
Zm
Zm
Zm
QB
QB
QB
QB
QB
QB
QB
QB
uH
"}
(11,1,1) = {"
uH
uH
uH
QB
ac
wO
ac
ac
ac
BB
EG
EG
EG
EG
EG
EG
Od
BX
BX
px
px
px
QB
uH
"}
(12,1,1) = {"
uH
uH
uH
QB
ac
wO
ac
ac
ac
BB
EG
wa
wa
wa
wa
EG
Od
BX
Jm
px
px
px
QB
uH
"}
(13,1,1) = {"
uH
uH
uH
QB
ac
fI
ac
wO
ac
BB
EG
wa
wa
wa
wa
EG
Od
BX
BX
px
px
px
QB
uH
"}
(14,1,1) = {"
uH
uH
uH
QB
ac
wO
ac
ac
ac
BB
EG
wa
wa
wa
wa
EG
Od
BX
Rw
px
px
px
QB
uH
"}
(15,1,1) = {"
uH
uH
uH
QB
ac
wO
ac
ac
ac
BB
EG
wa
wa
wa
wa
EG
Od
BX
BX
px
px
px
QB
uH
"}
(16,1,1) = {"
uH
uH
uH
QB
ac
ac
ac
wO
ac
BB
EG
EG
EG
EG
EG
EG
Od
BX
NE
px
px
Rt
QB
uH
"}
(17,1,1) = {"
uH
uH
uH
QB
ac
wO
ac
ac
ac
BB
EG
EG
EG
EG
EG
EG
Od
BX
BX
px
px
px
QB
uH
"}
(18,1,1) = {"
uH
uH
uH
QB
ac
wO
ac
ac
ac
BB
EG
EG
EG
rJ
EG
EG
Od
BX
BX
px
px
px
QB
uH
"}
(19,1,1) = {"
uH
uH
uH
QB
ac
ac
ac
wO
ac
BB
EG
EG
EG
EG
EG
EG
Od
BX
Rw
px
px
px
QB
uH
"}
(20,1,1) = {"
uH
uH
uH
QB
ac
wO
ac
ac
ac
BB
EG
wa
wa
wa
wa
EG
Od
BX
BX
px
px
px
QB
uH
"}
(21,1,1) = {"
uH
uH
uH
QB
ac
wO
ac
ac
ac
BB
EG
wa
wa
wa
wa
EG
Od
BX
BX
px
px
px
QB
uH
"}
(22,1,1) = {"
uH
uH
uH
QB
ac
ac
ac
wO
ac
BB
EG
wa
wa
wa
wa
EG
Od
BX
BX
NE
px
px
QB
uH
"}
(23,1,1) = {"
uH
uH
uH
QB
ac
wO
ac
ac
ac
BB
EG
wa
wa
wa
wa
EG
nP
wn
BX
BX
BX
px
QB
uH
"}
(24,1,1) = {"
uH
uH
uH
QB
ac
wO
ac
ac
ac
BB
EG
wa
wa
wa
wa
EG
Zw
Zw
wn
BX
BX
BX
QB
uH
"}
(25,1,1) = {"
uH
uH
uH
QB
ac
fI
ac
wO
ac
BB
EG
EG
EG
EG
EG
EG
Zw
Zw
Od
BX
BX
BX
QB
uH
"}
(26,1,1) = {"
uH
uH
uH
QB
ac
wO
ac
dl
PZ
Zb
EG
EG
EG
EG
EG
EG
Zw
Zw
nP
wn
BX
BX
QB
uH
"}
(27,1,1) = {"
uH
uH
uH
QB
ac
wO
dl
fw
Zw
Zw
EG
EG
EG
EG
EG
EG
Zw
wa
Zw
nP
wn
BX
QB
uH
"}
(28,1,1) = {"
uH
uH
uH
QB
ac
ac
Xk
Zw
SI
Zw
EG
wa
wa
wa
wa
EG
Zw
wa
wa
Zw
Od
BX
QB
uH
"}
(29,1,1) = {"
uH
uH
uH
QB
ac
wO
Xk
TL
Zw
Zw
EG
wa
wa
wa
wa
EG
Zw
wa
wa
Zw
Od
BX
QB
uH
"}
(30,1,1) = {"
uH
uH
uH
QB
ac
wO
Xk
zP
Zw
Zw
EG
wa
wa
xd
wa
EG
Zw
wa
wa
Zw
Od
Qe
QB
uH
"}
(31,1,1) = {"
uH
uH
uH
QB
ac
ac
Xk
Zw
Tc
Zw
EG
wa
wa
wa
wa
EG
Zw
wa
wa
Zw
Od
Qe
QB
uH
"}
(32,1,1) = {"
uH
uH
uH
QB
ac
wO
cJ
qk
Zw
Zw
EG
EG
EG
EG
EG
EG
Zw
wa
Zw
iE
xx
Qe
QB
uH
"}
(33,1,1) = {"
uH
uH
uH
QB
ac
wO
ac
cJ
WW
zq
EG
EG
EG
EG
EG
EG
Zw
Zw
iE
xx
Qe
Qe
QB
uH
"}
(34,1,1) = {"
uH
uH
uH
QB
ac
fI
ac
wO
ac
BB
EG
EG
EG
EG
EG
EG
Zw
Zw
Od
Qe
Qe
Qe
QB
uH
"}
(35,1,1) = {"
uH
uH
uH
QB
ac
wO
ac
ac
ac
BB
EG
wa
wa
wa
wa
EG
Zw
iE
xx
Qe
Qe
px
QB
uH
"}
(36,1,1) = {"
uH
uH
uH
QB
ac
wO
ac
ac
ac
BB
EG
wa
wa
wa
wa
EG
iE
xx
Qe
Qe
Qe
px
QB
uH
"}
(37,1,1) = {"
uH
uH
uH
QB
ac
ac
ac
wO
ac
BB
EG
wa
wa
wa
wa
EG
Od
Qe
Qe
Qe
px
px
QB
uH
"}
(38,1,1) = {"
uH
uH
uH
QB
ac
wO
ac
ac
ac
BB
EG
wa
wa
wa
wa
EG
Od
Qe
Qe
px
px
px
QB
uH
"}
(39,1,1) = {"
uH
uH
uH
QB
ac
wO
ac
ac
ac
BB
EG
wa
wa
wa
wa
EG
Od
Qe
Qe
Qe
px
px
QB
uH
"}
(40,1,1) = {"
uH
uH
uH
QB
ac
ac
ac
wO
ac
BB
EG
EG
EG
EG
EG
EG
Od
Qe
Qe
Qe
px
px
QB
uH
"}
(41,1,1) = {"
uH
uH
uH
QB
ac
wO
ac
ac
ac
BB
EG
EG
EG
EG
EG
EG
Od
Qe
Qe
px
px
px
QB
uH
"}
(42,1,1) = {"
uH
uH
uH
QB
ac
wO
ac
ac
ac
BB
EG
EG
EG
rJ
EG
EG
Od
Qe
Qe
px
px
px
QB
uH
"}
(43,1,1) = {"
uH
uH
uH
QB
ac
ac
ac
wO
ac
BB
EG
EG
EG
EG
EG
EG
Od
Qe
Qe
Qe
Qe
Rt
QB
uH
"}
(44,1,1) = {"
uH
uH
uH
QB
ac
wO
ac
ac
ac
BB
EG
wa
wa
wa
wa
EG
Od
Qe
Qe
px
px
px
QB
uH
"}
(45,1,1) = {"
uH
uH
uH
QB
ac
wO
ac
ac
ac
BB
EG
wa
wa
wa
wa
EG
Od
Qe
Qe
px
px
px
QB
uH
"}
(46,1,1) = {"
uH
uH
uH
QB
ac
fI
ac
wO
ac
BB
EG
wa
wa
wa
wa
EG
Od
Qe
Qe
Qe
px
px
QB
uH
"}
(47,1,1) = {"
uH
uH
uH
QB
ac
wO
ac
ac
ac
BB
EG
wa
wa
wa
wa
EG
Od
Qe
Qe
px
px
px
QB
uH
"}
(48,1,1) = {"
uH
uH
uH
QB
ac
wO
ac
ac
ac
BB
EG
EG
EG
EG
EG
EG
Od
Qe
Qe
px
px
px
QB
uH
"}
(49,1,1) = {"
uH
uH
uH
QB
QB
QB
QB
QB
QB
QB
QB
Zm
Zm
Zm
Zm
QB
QB
QB
QB
QB
QB
QB
QB
uH
"}
(50,1,1) = {"
uH
uH
uH
uH
uH
uH
uH
QB
vA
Sq
eb
EG
EG
EG
EG
EG
wa
wa
QB
ec
ec
ec
ec
ec
"}
(51,1,1) = {"
uH
uH
uH
uH
uH
uH
uH
QB
vA
wz
EG
wa
wa
wa
wa
wa
wa
iK
QB
ec
ec
ec
ec
ec
"}
(52,1,1) = {"
uH
uH
uH
uH
uH
uH
uH
QB
vA
wz
wa
wa
wa
JX
wa
zj
EG
EG
QB
QB
QB
QB
ec
ec
"}
(53,1,1) = {"
uH
uH
uH
uH
uH
uH
uH
QB
vA
CA
wa
wa
Gp
Gp
Gp
wa
wa
wa
wa
Gp
QK
wN
ec
ec
"}
(54,1,1) = {"
uH
uH
uH
uH
uH
uH
uH
QB
vA
wz
wa
wa
wa
wa
id
wa
wa
wa
wa
wa
id
wN
ec
ec
"}
(55,1,1) = {"
uH
uH
uH
uH
uH
uH
uH
QB
vA
wz
wa
wa
JX
wa
xd
wa
wa
wa
wa
JX
wa
wN
ec
Kd
"}
(56,1,1) = {"
uH
uH
uH
uH
uH
uH
uH
QB
vA
wz
wa
wa
Gp
lG
Gp
wa
wa
wa
wa
QK
Gp
wN
ec
ec
"}
(57,1,1) = {"
uH
uH
uH
uH
uH
uH
uH
QB
vA
wz
wa
wa
wa
id
wa
zj
EG
EG
QB
QB
QB
QB
ec
ec
"}
(58,1,1) = {"
uH
uH
uH
uH
uH
uH
uH
QB
vA
wz
EG
wa
wa
wa
wa
wa
wa
iK
QB
ec
ec
ec
ec
ec
"}
(59,1,1) = {"
uH
uH
uH
uH
uH
uH
uH
QB
vA
wz
EG
EG
EG
EG
EG
EG
wa
wa
QB
ec
ec
ec
ec
ec
"}
(60,1,1) = {"
uH
uH
uH
uH
uH
uH
uH
QB
QB
QB
QB
QB
QB
QB
QB
QB
QB
QB
QB
ec
ec
ec
ec
ec
"}
