//MAP CONVERTED BY dmm2tgm.py THIS HEADER COMMENT PREVENTS RECONVERSION, DO NOT REMOVE
"aw" = (
/obj/structure/door_assembly/door_assembly_science,
/turf/open/floor/plasteel/airless,
/area/ruin/has_grav/teg)
"bX" = (
/obj/item/stack/sheet/metal,
/turf/open/floor/plasteel/airless,
/area/ruin/has_grav/teg)
"cg" = (
/obj/effect/decal/cleanable/dirt,
/turf/open/floor/plasteel/airless,
/area/ruin/has_grav/teg/eva)
"cL" = (
/turf/open/floor/plating/airless,
/area/ruin/has_grav/teg)
"eI" = (
/obj/structure/table/optable,
/obj/effect/mob_spawn/human/doctor,
/turf/open/floor/plasteel/airless,
/area/ruin/has_grav/teg)
"eZ" = (
/turf/open/floor/plating/airless,
/area/ruin/has_grav/teg/storage)
"fF" = (
/turf/closed/wall,
/area/ruin/has_grav/teg)
"gQ" = (
/obj/item/mmi,
/obj/structure/table,
/obj/item/circular_saw,
/turf/open/floor/plasteel/airless,
/area/ruin/has_grav/teg)
"hg" = (
/obj/effect/decal/cleanable/blood,
/turf/open/floor/plasteel/airless,
/area/ruin/has_grav/teg)
"hC" = (
/obj/structure/girder,
/obj/item/stack/sheet/metal,
/turf/closed/wall,
/area/ruin/has_grav/teg)
"hW" = (
/turf/open/floor/plating/airless{
	icon_state = "platingdmg2"
	},
/area/ruin/has_grav/teg)
"iy" = (
/obj/item/stock_parts/manipulator,
/turf/open/floor/plasteel/airless,
/area/ruin/has_grav/teg)
"jQ" = (
/obj/item/clothing/shoes/magboots,
/turf/open/floor/plasteel/airless,
/area/ruin/has_grav/teg/eva)
"kM" = (
/obj/structure/girder,
/turf/closed/wall,
/area/ruin/has_grav/teg/storage)
"kU" = (
/obj/effect/decal/cleanable/dirt,
/turf/open/floor/plasteel/airless,
/area/ruin/has_grav/teg)
"lb" = (
/obj/machinery/atmospherics/pipe/simple/general/visible{
	dir = 8
	},
/obj/effect/decal/cleanable/dirt,
/turf/open/floor/plating/airless,
/area/ruin/has_grav/teg)
"lE" = (
/turf/open/floor/plating/airless{
	icon_state = "platingdmg1"
	},
/area/ruin/has_grav/teg)
"mr" = (
/obj/machinery/door/airlock/external,
/turf/open/floor/plating/airless{
	icon_state = "panelscorched"
	},
/area/ruin/has_grav/teg/eva)
"ov" = (
/obj/item/tank/jetpack,
/turf/open/floor/plasteel/airless,
/area/ruin/has_grav/teg/eva)
"oS" = (
/turf/closed/wall,
/area/ruin/has_grav/teg/eva)
"py" = (
/obj/machinery/atmospherics/pipe/simple/general/visible{
	dir = 5
	},
/turf/open/floor/plasteel/airless,
/area/ruin/has_grav/teg)
"qI" = (
/obj/machinery/door/airlock/engineering,
/turf/open/floor/plating/airless{
	icon_state = "platingdmg1"
	},
/area/ruin/has_grav/teg/eva)
"qM" = (
/obj/structure/girder,
/turf/closed/wall,
/area/ruin/has_grav/teg)
"rr" = (
/turf/open/floor/plasteel/airless,
/area/ruin/has_grav/teg/storage)
"rv" = (
/turf/closed/wall,
/area/ruin/has_grav/teg/storage)
"rL" = (
/obj/effect/decal/cleanable/blood,
/obj/effect/mob_spawn/human/engineer,
/turf/open/floor/plasteel/airless,
/area/ruin/has_grav/teg/eva)
"tj" = (
/obj/effect/decal/cleanable/dirt,
/turf/open/floor/plating/airless,
/area/ruin/has_grav/teg/storage)
"tG" = (
/turf/open/floor/plating/airless,
/area/ruin/has_grav/teg/eva)
"uY" = (
/obj/effect/decal/cleanable/dirt/dust,
/turf/open/floor/plating/airless,
/area/ruin/has_grav/teg)
"vd" = (
/obj/structure/closet/crate{
	icon_state = "crateopen"
	},
/obj/item/wrench,
/obj/item/mecha_parts/part/ripley_left_leg,
/turf/open/floor/plasteel/airless,
/area/ruin/has_grav/teg)
"vM" = (
/obj/machinery/atmospherics/pipe/simple/general/visible,
/turf/open/floor/plasteel/airless,
/area/ruin/has_grav/teg)
"vV" = (
/obj/structure/mecha_wreckage/ripley,
/turf/open/floor/plasteel/airless,
/area/ruin/has_grav/teg)
"wg" = (
/obj/effect/decal/cleanable/dirt,
/turf/open/floor/plasteel/airless,
/area/ruin/has_grav/teg/storage)
"xE" = (
/obj/machinery/atmospherics/pipe/simple/general/visible{
	dir = 9
	},
/obj/effect/decal/cleanable/dirt,
/turf/open/floor/plasteel/airless,
/area/ruin/has_grav/teg)
"ye" = (
/obj/structure/mecha_wreckage/clarke,
/turf/open/floor/plasteel/airless,
/area/ruin/has_grav/teg)
"za" = (
/obj/machinery/atmospherics/pipe/simple/general/visible{
	dir = 8
	},
/turf/open/floor/plasteel/airless,
/area/ruin/has_grav/teg)
"zs" = (
/obj/effect/decal/cleanable/blood,
/turf/open/floor/plasteel/airless,
/area/ruin/has_grav/teg/storage)
"zR" = (
/obj/item/stack/rods,
/turf/closed/wall,
/area/ruin/has_grav/teg)
"Cv" = (
/turf/open/floor/plating/airless{
	icon_state = "platingdmg3"
	},
/area/ruin/has_grav/teg)
"DF" = (
/obj/machinery/mech_bay_recharge_port,
/turf/open/floor/plasteel/airless,
/area/ruin/has_grav/teg)
"DL" = (
/obj/machinery/atmospherics/pipe/simple/general/visible{
	dir = 6
	},
/turf/open/floor/plasteel/airless,
/area/ruin/has_grav/teg)
"DW" = (
/obj/machinery/power/generator,
/turf/open/floor/plasteel/airless,
/area/ruin/has_grav/teg)
"Ev" = (
/obj/item/circuitboard/machine/circulator,
/obj/structure/closet/crate/engineering{
	icon_state = "engi_crateopen";
	opened = 1
	},
/obj/item/stack/cable_coil,
/obj/item/stack/sheet/metal/fifty,
/obj/item/wirecutters,
/obj/item/screwdriver,
/turf/open/floor/plasteel/airless,
/area/ruin/has_grav/teg/storage)
"Fv" = (
/obj/machinery/atmospherics/components/unary/thermomachine/heater,
/turf/open/floor/plasteel/airless,
/area/ruin/has_grav/teg)
"FC" = (
/obj/structure/closet/crate{
	icon_state = "crateopen"
	},
/obj/item/stack/cable_coil,
/obj/item/storage/firstaid/fire,
/obj/item/storage/firstaid/brute,
/turf/open/floor/plasteel/airless,
/area/ruin/has_grav/teg/storage)
"FP" = (
/obj/item/stock_parts/capacitor,
/turf/open/floor/plasteel/airless,
/area/ruin/has_grav/teg)
"Gk" = (
/obj/item/stack/rods,
/turf/open/floor/plating/airless,
/area/ruin/has_grav/teg)
"Gx" = (
/obj/machinery/atmospherics/pipe/manifold/general/visible,
/turf/open/floor/plasteel/airless,
/area/ruin/has_grav/teg)
"GH" = (
/obj/effect/decal/cleanable/blood,
/obj/effect/decal/cleanable/dirt,
/turf/open/floor/plasteel/airless,
/area/ruin/has_grav/teg)
"Hs" = (
/obj/machinery/atmospherics/pipe/simple/general/visible,
/obj/effect/decal/cleanable/dirt,
/turf/open/floor/plasteel/airless,
/area/ruin/has_grav/teg)
"IX" = (
/obj/structure/closet/crate{
	icon_state = "crateopen"
	},
/obj/item/stack/sheet/metal/fifty,
/obj/item/screwdriver,
/obj/item/gps,
/turf/open/floor/plasteel/airless,
/area/ruin/has_grav/teg/storage)
"Jb" = (
/turf/open/floor/plating/airless{
	icon_state = "panelscorched"
	},
/area/ruin/has_grav/teg/storage)
"KP" = (
/obj/structure/closet/crate{
	icon_state = "crateopen"
	},
/obj/item/weldingtool,
/obj/item/stack/sheet/metal/fifty,
/obj/item/screwdriver,
/turf/open/floor/plasteel/airless,
/area/ruin/has_grav/teg/storage)
"La" = (
/obj/machinery/atmospherics/pipe/manifold/general/visible{
	dir = 8
	},
/turf/open/floor/plasteel/airless,
/area/ruin/has_grav/teg)
"Lj" = (
/obj/item/stack/sheet/metal,
/turf/closed/wall,
/area/ruin/has_grav/teg)
"Mq" = (
/turf/open/floor/plating/airless{
	icon_state = "panelscorched"
	},
/area/ruin/has_grav/teg)
"NG" = (
/obj/structure/closet/crate{
	icon_state = "crateopen"
	},
/obj/item/lightreplacer,
/obj/item/mecha_parts/part/durand_right_arm,
/obj/item/paicard,
/obj/item/circuitboard/computer/mecha_control,
/turf/open/floor/plasteel/airless,
/area/ruin/has_grav/teg)
"NI" = (
/obj/structure/girder,
/turf/closed/wall,
/area/ruin/has_grav/teg/eva)
"Oe" = (
/obj/item/stack/rods,
/turf/open/floor/plasteel/airless,
/area/ruin/has_grav/teg)
"Ow" = (
/turf/template_noop,
/area/template_noop)
"OT" = (
/obj/item/stock_parts/matter_bin,
/turf/open/floor/plasteel/airless,
/area/ruin/has_grav/teg)
"QU" = (
/obj/structure/girder,
/turf/open/floor/plasteel/airless,
/area/ruin/has_grav/teg)
"Rr" = (
/obj/machinery/atmospherics/pipe/simple/general/visible{
	dir = 4
	},
/turf/open/floor/plasteel/airless,
/area/ruin/has_grav/teg)
"RS" = (
/obj/machinery/atmospherics/components/unary/thermomachine/freezer,
/turf/open/floor/plating/airless{
	icon_state = "platingdmg1"
	},
/area/ruin/has_grav/teg)
"RW" = (
/obj/structure/closet/crate{
	icon_state = "crateopen"
	},
/obj/item/multitool,
/obj/item/mecha_parts/part/clarke_head,
/turf/open/floor/plasteel/airless,
/area/ruin/has_grav/teg)
"SV" = (
/turf/open/floor/plating/airless{
	icon_state = "panelscorched"
	},
/area/ruin/has_grav/teg/eva)
"SZ" = (
/obj/effect/mob_spawn/human/skeleton/alive,
/obj/item/stack/cable_coil,
/turf/open/floor/plasteel/airless,
/area/ruin/has_grav/teg/eva)
"Ub" = (
/obj/structure/door_assembly/door_assembly_mai,
/turf/open/floor/plating/airless,
/area/ruin/has_grav/teg/storage)
"UH" = (
/obj/effect/decal/cleanable/dirt/dust,
/turf/open/floor/plasteel/airless,
/area/ruin/has_grav/teg)
"UR" = (
/obj/structure/closet/crate{
	icon_state = "crateopen"
	},
/obj/item/weldingtool,
/obj/item/stack/cable_coil,
/obj/item/wirecutters,
/obj/item/screwdriver,
/turf/open/floor/plasteel/airless,
/area/ruin/has_grav/teg/storage)
"Vu" = (
/obj/machinery/atmospherics/components/binary/circulator/cold{
	dir = 8
	},
/turf/open/floor/plasteel/airless,
/area/ruin/has_grav/teg)
"VK" = (
/turf/open/floor/plasteel/airless,
/area/ruin/has_grav/teg/eva)
"Zj" = (
/obj/machinery/suit_storage_unit/standard_unit,
/turf/open/floor/plasteel/airless,
/area/ruin/has_grav/teg/eva)
"Zr" = (
/turf/open/floor/plasteel/airless,
/area/ruin/has_grav/teg)
"ZH" = (
/obj/machinery/door/airlock/external,
/turf/open/floor/plating/airless{
	icon_state = "platingdmg1"
	},
/area/ruin/has_grav/teg/eva)

(1,1,1) = {"
Ow
Ow
Ow
Ow
Ow
Ow
Ow
Ow
Ow
Ow
Ow
Ow
Ow
Ow
Ow
Ow
Ow
Ow
Ow
Ow
Ow
Ow
Ow
Ow
Ow
Ow
Ow
Ow
Ow
Ow
Ow
Ow
Ow
Ow
Ow
Ow
Ow
Ow
Ow
Ow
Ow
Ow
Ow
Ow
Ow
Ow
Ow
Ow
Ow
Ow
"}
(2,1,1) = {"
Ow
Ow
Ow
Ow
Ow
Ow
Ow
Ow
Ow
Ow
Ow
Ow
Ow
Ow
Ow
Ow
Ow
Ow
Ow
Ow
Ow
Ow
Ow
Ow
Ow
Ow
Ow
Ow
Ow
Ow
Ow
Ow
Ow
Ow
Ow
Ow
Ow
Ow
Ow
Ow
Ow
Ow
Ow
Ow
Ow
Ow
Ow
Ow
Ow
Ow
"}
(3,1,1) = {"
Ow
Ow
Ow
Ow
Ow
Ow
Ow
Ow
Ow
Ow
Ow
Ow
Ow
Ow
Ow
Ow
Ow
Ow
Ow
Ow
Ow
Ow
Ow
Ow
Ow
Ow
Ow
Ow
Ow
Ow
Ow
Ow
Ow
Ow
Ow
Ow
Ow
Ow
Ow
Ow
Ow
Ow
Ow
Ow
Ow
Ow
Ow
Ow
Ow
Ow
"}
(4,1,1) = {"
Ow
Ow
Ow
Ow
Ow
Ow
Ow
Ow
Ow
Ow
Ow
Ow
Ow
Ow
Ow
Ow
Ow
Ow
Ow
Ow
Ow
Ow
Ow
Ow
Ow
Ow
Ow
Ow
Ow
Ow
Ow
Ow
Ow
Ow
Ow
Ow
Ow
Ow
Ow
Ow
Ow
Ow
Ow
Ow
Ow
Ow
Ow
Ow
Ow
Ow
"}
(5,1,1) = {"
Ow
Ow
Ow
Ow
Ow
Ow
Ow
Ow
Ow
Ow
Ow
Ow
Ow
Ow
Ow
Ow
Ow
Ow
Ow
Ow
Ow
Ow
Ow
Ow
Ow
Ow
Ow
Ow
Ow
Ow
Ow
Ow
Ow
Ow
Ow
Ow
Ow
Ow
Ow
Ow
Ow
Ow
Ow
Ow
Ow
Ow
Ow
Ow
Ow
Ow
"}
(6,1,1) = {"
Ow
Ow
Ow
Ow
Ow
Ow
Ow
Ow
Ow
Ow
Ow
Ow
Ow
Ow
Ow
Ow
Ow
Ow
Ow
Ow
Ow
Ow
Ow
Ow
Ow
Ow
Ow
Ow
Ow
Ow
Ow
Ow
Ow
Ow
Ow
Ow
Ow
Ow
Ow
Ow
Ow
Ow
Ow
Ow
Ow
Ow
Ow
Ow
Ow
Ow
"}
(7,1,1) = {"
Ow
Ow
Ow
Ow
Ow
Ow
Ow
Ow
Ow
Ow
Ow
Ow
Ow
Ow
Ow
Ow
Ow
Ow
Ow
Ow
Ow
Ow
Ow
Ow
Ow
Ow
Ow
Ow
Ow
Ow
Ow
Ow
Ow
Ow
Ow
Ow
Ow
Ow
Ow
Ow
Ow
Ow
Ow
Ow
Ow
Ow
Ow
Ow
Ow
Ow
"}
(8,1,1) = {"
Ow
Ow
Ow
Ow
Ow
Ow
Ow
Ow
Ow
Ow
Ow
Ow
Ow
Ow
Ow
Ow
Ow
Ow
Ow
Ow
Ow
Ow
Ow
Ow
Ow
Ow
Ow
Ow
Ow
Ow
Ow
Ow
Ow
Ow
Ow
Ow
Ow
Ow
Ow
Ow
Ow
Ow
Ow
Ow
Ow
Ow
Ow
Ow
Ow
Ow
"}
(9,1,1) = {"
Ow
Ow
Ow
Ow
Ow
Ow
Ow
Ow
Ow
Ow
Ow
Ow
Ow
Ow
Ow
Ow
Ow
Ow
Ow
Ow
Ow
Ow
Ow
Ow
Ow
Ow
Ow
Ow
Ow
Ow
Ow
Ow
Ow
Ow
Ow
Ow
Ow
Ow
Ow
Ow
Ow
Ow
Ow
Ow
Ow
Ow
Ow
Ow
Ow
Ow
"}
(10,1,1) = {"
Ow
Ow
Ow
Ow
Ow
Ow
Ow
Ow
Ow
Ow
fF
fF
qM
qM
qM
fF
fF
fF
fF
fF
hC
qM
fF
fF
fF
rv
rv
rv
rv
rv
rv
Ow
Ow
Ow
Ow
Ow
Ow
Ow
Ow
Ow
Ow
Ow
Ow
Ow
Ow
Ow
Ow
Ow
Ow
Ow
"}
(11,1,1) = {"
Ow
Ow
Ow
Ow
Ow
Ow
Ow
Ow
Ow
Ow
fF
Zr
Zr
Cv
vd
bX
Zr
Zr
Zr
Zr
Zr
Zr
Zr
Zr
Zr
rv
KP
Jb
rr
FC
rv
Ow
Ow
Ow
Ow
Ow
Ow
Ow
Ow
Ow
Ow
Ow
Ow
Ow
Ow
Ow
Ow
Ow
Ow
Ow
"}
(12,1,1) = {"
Ow
Ow
Ow
Ow
Ow
Ow
Ow
Ow
Ow
Ow
fF
RW
cL
cL
UH
UH
UH
UH
UH
UH
UH
UH
cL
hW
Zr
rv
rr
wg
rr
rr
kM
Ow
Ow
Ow
Ow
Ow
Ow
Ow
Ow
Ow
Ow
Ow
Ow
Ow
Ow
Ow
Ow
Ow
Ow
Ow
"}
(13,1,1) = {"
Ow
Ow
Ow
Ow
Ow
Ow
Ow
Ow
Ow
Ow
fF
Zr
Mq
Zr
Zr
cL
cL
cL
cL
RS
Zr
UH
UH
Zr
Gk
kM
zs
rr
Ev
wg
rv
Ow
Ow
Ow
Ow
Ow
Ow
Ow
Ow
Ow
Ow
Ow
Ow
Ow
Ow
Ow
Ow
Ow
Ow
Ow
"}
(14,1,1) = {"
Ow
Ow
Ow
Ow
Ow
Ow
Ow
Ow
Ow
Ow
fF
bX
Zr
Zr
Zr
Zr
Zr
DL
vM
Zr
Zr
Zr
UH
UH
Zr
rv
rr
rr
rr
tj
kM
Ow
Ow
Ow
Ow
Ow
Ow
Ow
Ow
Ow
Ow
Ow
Ow
Ow
Ow
Ow
Ow
Ow
Ow
Ow
"}
(15,1,1) = {"
Ow
Ow
Ow
Ow
Ow
Ow
Ow
Ow
Ow
Ow
qM
Zr
Zr
UH
UH
Zr
lE
lb
kU
Zr
za
Zr
Zr
UH
Zr
rv
rr
UR
rr
wg
rv
Ow
Ow
Ow
Ow
Ow
Ow
Ow
Ow
Ow
Ow
Ow
Ow
Ow
Ow
Ow
Ow
Ow
Ow
Ow
"}
(16,1,1) = {"
Ow
Ow
Ow
Ow
Ow
Ow
Ow
Ow
Ow
Ow
qM
Zr
Zr
Zr
Zr
UH
uY
Zr
Zr
Hs
xE
Zr
Zr
UH
Zr
Ub
tj
eZ
rr
zs
rv
Ow
Ow
Ow
Ow
Ow
Ow
Ow
Ow
Ow
Ow
Ow
Ow
Ow
Ow
Ow
Ow
Ow
Ow
Ow
"}
(17,1,1) = {"
Ow
Ow
Ow
Ow
Ow
Ow
Ow
Ow
Ow
Ow
fF
Zr
Zr
UH
Zr
Zr
UH
Zr
DW
Zr
Zr
GH
Zr
Mq
Zr
rv
wg
rr
rr
IX
rv
Ow
Ow
Ow
Ow
Ow
Ow
Ow
Ow
Ow
Ow
Ow
Ow
Ow
Ow
Ow
Ow
Ow
Ow
Ow
"}
(18,1,1) = {"
Ow
Ow
Ow
Ow
Ow
Ow
Ow
Ow
Ow
Ow
fF
fF
fF
zR
aw
QU
Zr
DL
Vu
vM
py
Zr
kU
Zr
Zr
oS
oS
NI
oS
oS
oS
Ow
Ow
Ow
Ow
Ow
Ow
Ow
Ow
Ow
Ow
Ow
Ow
Ow
Ow
Ow
Ow
Ow
Ow
Ow
"}
(19,1,1) = {"
Ow
Ow
Ow
Ow
Ow
Ow
Ow
Ow
Ow
Ow
fF
DF
cL
Zr
Zr
QU
Cv
Gx
Zr
Zr
za
Zr
Zr
UH
Zr
oS
cg
VK
VK
jQ
oS
Ow
Ow
Ow
Ow
Ow
Ow
Ow
Ow
Ow
Ow
Ow
Ow
Ow
Ow
Ow
Ow
Ow
Ow
Ow
"}
(20,1,1) = {"
Ow
Ow
Ow
Ow
Ow
Ow
Ow
Ow
Ow
Ow
fF
vV
cL
OT
Zr
fF
QU
cL
Cv
cL
Rr
Zr
UH
cL
Zr
qI
VK
VK
VK
SZ
oS
Ow
Ow
Ow
Ow
Ow
Ow
Ow
Ow
Ow
Ow
Ow
Ow
Ow
Ow
Ow
Ow
Ow
Ow
Ow
"}
(21,1,1) = {"
Ow
Ow
Ow
Ow
Ow
Ow
Ow
Ow
Ow
Ow
fF
Zr
lE
Zr
ye
fF
Oe
Zr
vM
La
Zr
UH
cL
cL
Zr
oS
VK
VK
SV
cg
NI
Ow
Ow
Ow
Ow
Ow
Ow
Ow
Ow
Ow
Ow
Ow
Ow
Ow
Ow
Ow
Ow
Ow
Ow
Ow
"}
(22,1,1) = {"
Ow
Ow
Ow
Ow
Ow
Ow
Ow
Ow
Ow
Ow
qM
bX
cL
Zr
Zr
QU
Zr
Zr
Zr
Fv
Zr
uY
hW
Zr
Zr
NI
VK
rL
VK
cg
NI
Ow
Ow
Ow
Ow
Ow
Ow
Ow
Ow
Ow
Ow
Ow
Ow
Ow
Ow
Ow
Ow
Ow
Ow
Ow
"}
(23,1,1) = {"
Ow
Ow
Ow
Ow
Ow
Ow
Ow
Ow
Ow
Ow
qM
iy
cL
hg
FP
fF
Lj
bX
Zr
Zr
cL
cL
Zr
Zr
Zr
oS
cg
tG
VK
Zj
oS
Ow
Ow
Ow
Ow
Ow
Ow
Ow
Ow
Ow
Ow
Ow
Ow
Ow
Ow
Ow
Ow
Ow
Ow
Ow
"}
(24,1,1) = {"
Ow
Ow
Ow
Ow
Ow
Ow
Ow
Ow
Ow
Ow
qM
Zr
gQ
eI
Zr
NG
fF
Zr
Zr
Zr
Zr
Zr
Zr
Zr
Zr
oS
ov
VK
VK
Zj
oS
Ow
Ow
Ow
Ow
Ow
Ow
Ow
Ow
Ow
Ow
Ow
Ow
Ow
Ow
Ow
Ow
Ow
Ow
Ow
"}
(25,1,1) = {"
Ow
Ow
Ow
Ow
Ow
Ow
Ow
Ow
Ow
Ow
fF
fF
fF
fF
fF
fF
qM
fF
qM
fF
qM
qM
fF
qM
fF
oS
oS
mr
oS
oS
oS
Ow
Ow
Ow
Ow
Ow
Ow
Ow
Ow
Ow
Ow
Ow
Ow
Ow
Ow
Ow
Ow
Ow
Ow
Ow
"}
(26,1,1) = {"
Ow
Ow
Ow
Ow
Ow
Ow
Ow
Ow
Ow
Ow
Ow
Ow
Ow
Ow
Ow
Ow
Ow
Ow
Ow
Ow
Ow
Ow
Ow
Ow
Ow
Ow
oS
tG
oS
Ow
Ow
Ow
Ow
Ow
Ow
Ow
Ow
Ow
Ow
Ow
Ow
Ow
Ow
Ow
Ow
Ow
Ow
Ow
Ow
Ow
"}
(27,1,1) = {"
Ow
Ow
Ow
Ow
Ow
Ow
Ow
Ow
Ow
Ow
Ow
Ow
Ow
Ow
Ow
Ow
Ow
Ow
Ow
Ow
Ow
Ow
Ow
Ow
Ow
Ow
oS
ZH
oS
Ow
Ow
Ow
Ow
Ow
Ow
Ow
Ow
Ow
Ow
Ow
Ow
Ow
Ow
Ow
Ow
Ow
Ow
Ow
Ow
Ow
"}
(28,1,1) = {"
Ow
Ow
Ow
Ow
Ow
Ow
Ow
Ow
Ow
Ow
Ow
Ow
Ow
Ow
Ow
Ow
Ow
Ow
Ow
Ow
Ow
Ow
Ow
Ow
Ow
Ow
Ow
Ow
Ow
Ow
Ow
Ow
Ow
Ow
Ow
Ow
Ow
Ow
Ow
Ow
Ow
Ow
Ow
Ow
Ow
Ow
Ow
Ow
Ow
Ow
"}
(29,1,1) = {"
Ow
Ow
Ow
Ow
Ow
Ow
Ow
Ow
Ow
Ow
Ow
Ow
Ow
Ow
Ow
Ow
Ow
Ow
Ow
Ow
Ow
Ow
Ow
Ow
Ow
Ow
Ow
Ow
Ow
Ow
Ow
Ow
Ow
Ow
Ow
Ow
Ow
Ow
Ow
Ow
Ow
Ow
Ow
Ow
Ow
Ow
Ow
Ow
Ow
Ow
"}
(30,1,1) = {"
Ow
Ow
Ow
Ow
Ow
Ow
Ow
Ow
Ow
Ow
Ow
Ow
Ow
Ow
Ow
Ow
Ow
Ow
Ow
Ow
Ow
Ow
Ow
Ow
Ow
Ow
Ow
Ow
Ow
Ow
Ow
Ow
Ow
Ow
Ow
Ow
Ow
Ow
Ow
Ow
Ow
Ow
Ow
Ow
Ow
Ow
Ow
Ow
Ow
Ow
"}
(31,1,1) = {"
Ow
Ow
Ow
Ow
Ow
Ow
Ow
Ow
Ow
Ow
Ow
Ow
Ow
Ow
Ow
Ow
Ow
Ow
Ow
Ow
Ow
Ow
Ow
Ow
Ow
Ow
Ow
Ow
Ow
Ow
Ow
Ow
Ow
Ow
Ow
Ow
Ow
Ow
Ow
Ow
Ow
Ow
Ow
Ow
Ow
Ow
Ow
Ow
Ow
Ow
"}
(32,1,1) = {"
Ow
Ow
Ow
Ow
Ow
Ow
Ow
Ow
Ow
Ow
Ow
Ow
Ow
Ow
Ow
Ow
Ow
Ow
Ow
Ow
Ow
Ow
Ow
Ow
Ow
Ow
Ow
Ow
Ow
Ow
Ow
Ow
Ow
Ow
Ow
Ow
Ow
Ow
Ow
Ow
Ow
Ow
Ow
Ow
Ow
Ow
Ow
Ow
Ow
Ow
"}
(33,1,1) = {"
Ow
Ow
Ow
Ow
Ow
Ow
Ow
Ow
Ow
Ow
Ow
Ow
Ow
Ow
Ow
Ow
Ow
Ow
Ow
Ow
Ow
Ow
Ow
Ow
Ow
Ow
Ow
Ow
Ow
Ow
Ow
Ow
Ow
Ow
Ow
Ow
Ow
Ow
Ow
Ow
Ow
Ow
Ow
Ow
Ow
Ow
Ow
Ow
Ow
Ow
"}
(34,1,1) = {"
Ow
Ow
Ow
Ow
Ow
Ow
Ow
Ow
Ow
Ow
Ow
Ow
Ow
Ow
Ow
Ow
Ow
Ow
Ow
Ow
Ow
Ow
Ow
Ow
Ow
Ow
Ow
Ow
Ow
Ow
Ow
Ow
Ow
Ow
Ow
Ow
Ow
Ow
Ow
Ow
Ow
Ow
Ow
Ow
Ow
Ow
Ow
Ow
Ow
Ow
"}
(35,1,1) = {"
Ow
Ow
Ow
Ow
Ow
Ow
Ow
Ow
Ow
Ow
Ow
Ow
Ow
Ow
Ow
Ow
Ow
Ow
Ow
Ow
Ow
Ow
Ow
Ow
Ow
Ow
Ow
Ow
Ow
Ow
Ow
Ow
Ow
Ow
Ow
Ow
Ow
Ow
Ow
Ow
Ow
Ow
Ow
Ow
Ow
Ow
Ow
Ow
Ow
Ow
"}
(36,1,1) = {"
Ow
Ow
Ow
Ow
Ow
Ow
Ow
Ow
Ow
Ow
Ow
Ow
Ow
Ow
Ow
Ow
Ow
Ow
Ow
Ow
Ow
Ow
Ow
Ow
Ow
Ow
Ow
Ow
Ow
Ow
Ow
Ow
Ow
Ow
Ow
Ow
Ow
Ow
Ow
Ow
Ow
Ow
Ow
Ow
Ow
Ow
Ow
Ow
Ow
Ow
"}
(37,1,1) = {"
Ow
Ow
Ow
Ow
Ow
Ow
Ow
Ow
Ow
Ow
Ow
Ow
Ow
Ow
Ow
Ow
Ow
Ow
Ow
Ow
Ow
Ow
Ow
Ow
Ow
Ow
Ow
Ow
Ow
Ow
Ow
Ow
Ow
Ow
Ow
Ow
Ow
Ow
Ow
Ow
Ow
Ow
Ow
Ow
Ow
Ow
Ow
Ow
Ow
Ow
"}
(38,1,1) = {"
Ow
Ow
Ow
Ow
Ow
Ow
Ow
Ow
Ow
Ow
Ow
Ow
Ow
Ow
Ow
Ow
Ow
Ow
Ow
Ow
Ow
Ow
Ow
Ow
Ow
Ow
Ow
Ow
Ow
Ow
Ow
Ow
Ow
Ow
Ow
Ow
Ow
Ow
Ow
Ow
Ow
Ow
Ow
Ow
Ow
Ow
Ow
Ow
Ow
Ow
"}
(39,1,1) = {"
Ow
Ow
Ow
Ow
Ow
Ow
Ow
Ow
Ow
Ow
Ow
Ow
Ow
Ow
Ow
Ow
Ow
Ow
Ow
Ow
Ow
Ow
Ow
Ow
Ow
Ow
Ow
Ow
Ow
Ow
Ow
Ow
Ow
Ow
Ow
Ow
Ow
Ow
Ow
Ow
Ow
Ow
Ow
Ow
Ow
Ow
Ow
Ow
Ow
Ow
"}
(40,1,1) = {"
Ow
Ow
Ow
Ow
Ow
Ow
Ow
Ow
Ow
Ow
Ow
Ow
Ow
Ow
Ow
Ow
Ow
Ow
Ow
Ow
Ow
Ow
Ow
Ow
Ow
Ow
Ow
Ow
Ow
Ow
Ow
Ow
Ow
Ow
Ow
Ow
Ow
Ow
Ow
Ow
Ow
Ow
Ow
Ow
Ow
Ow
Ow
Ow
Ow
Ow
"}
(41,1,1) = {"
Ow
Ow
Ow
Ow
Ow
Ow
Ow
Ow
Ow
Ow
Ow
Ow
Ow
Ow
Ow
Ow
Ow
Ow
Ow
Ow
Ow
Ow
Ow
Ow
Ow
Ow
Ow
Ow
Ow
Ow
Ow
Ow
Ow
Ow
Ow
Ow
Ow
Ow
Ow
Ow
Ow
Ow
Ow
Ow
Ow
Ow
Ow
Ow
Ow
Ow
"}
(42,1,1) = {"
Ow
Ow
Ow
Ow
Ow
Ow
Ow
Ow
Ow
Ow
Ow
Ow
Ow
Ow
Ow
Ow
Ow
Ow
Ow
Ow
Ow
Ow
Ow
Ow
Ow
Ow
Ow
Ow
Ow
Ow
Ow
Ow
Ow
Ow
Ow
Ow
Ow
Ow
Ow
Ow
Ow
Ow
Ow
Ow
Ow
Ow
Ow
Ow
Ow
Ow
"}
(43,1,1) = {"
Ow
Ow
Ow
Ow
Ow
Ow
Ow
Ow
Ow
Ow
Ow
Ow
Ow
Ow
Ow
Ow
Ow
Ow
Ow
Ow
Ow
Ow
Ow
Ow
Ow
Ow
Ow
Ow
Ow
Ow
Ow
Ow
Ow
Ow
Ow
Ow
Ow
Ow
Ow
Ow
Ow
Ow
Ow
Ow
Ow
Ow
Ow
Ow
Ow
Ow
"}
(44,1,1) = {"
Ow
Ow
Ow
Ow
Ow
Ow
Ow
Ow
Ow
Ow
Ow
Ow
Ow
Ow
Ow
Ow
Ow
Ow
Ow
Ow
Ow
Ow
Ow
Ow
Ow
Ow
Ow
Ow
Ow
Ow
Ow
Ow
Ow
Ow
Ow
Ow
Ow
Ow
Ow
Ow
Ow
Ow
Ow
Ow
Ow
Ow
Ow
Ow
Ow
Ow
"}
(45,1,1) = {"
Ow
Ow
Ow
Ow
Ow
Ow
Ow
Ow
Ow
Ow
Ow
Ow
Ow
Ow
Ow
Ow
Ow
Ow
Ow
Ow
Ow
Ow
Ow
Ow
Ow
Ow
Ow
Ow
Ow
Ow
Ow
Ow
Ow
Ow
Ow
Ow
Ow
Ow
Ow
Ow
Ow
Ow
Ow
Ow
Ow
Ow
Ow
Ow
Ow
Ow
"}
(46,1,1) = {"
Ow
Ow
Ow
Ow
Ow
Ow
Ow
Ow
Ow
Ow
Ow
Ow
Ow
Ow
Ow
Ow
Ow
Ow
Ow
Ow
Ow
Ow
Ow
Ow
Ow
Ow
Ow
Ow
Ow
Ow
Ow
Ow
Ow
Ow
Ow
Ow
Ow
Ow
Ow
Ow
Ow
Ow
Ow
Ow
Ow
Ow
Ow
Ow
Ow
Ow
"}
(47,1,1) = {"
Ow
Ow
Ow
Ow
Ow
Ow
Ow
Ow
Ow
Ow
Ow
Ow
Ow
Ow
Ow
Ow
Ow
Ow
Ow
Ow
Ow
Ow
Ow
Ow
Ow
Ow
Ow
Ow
Ow
Ow
Ow
Ow
Ow
Ow
Ow
Ow
Ow
Ow
Ow
Ow
Ow
Ow
Ow
Ow
Ow
Ow
Ow
Ow
Ow
Ow
"}
(48,1,1) = {"
Ow
Ow
Ow
Ow
Ow
Ow
Ow
Ow
Ow
Ow
Ow
Ow
Ow
Ow
Ow
Ow
Ow
Ow
Ow
Ow
Ow
Ow
Ow
Ow
Ow
Ow
Ow
Ow
Ow
Ow
Ow
Ow
Ow
Ow
Ow
Ow
Ow
Ow
Ow
Ow
Ow
Ow
Ow
Ow
Ow
Ow
Ow
Ow
Ow
Ow
"}
(49,1,1) = {"
Ow
Ow
Ow
Ow
Ow
Ow
Ow
Ow
Ow
Ow
Ow
Ow
Ow
Ow
Ow
Ow
Ow
Ow
Ow
Ow
Ow
Ow
Ow
Ow
Ow
Ow
Ow
Ow
Ow
Ow
Ow
Ow
Ow
Ow
Ow
Ow
Ow
Ow
Ow
Ow
Ow
Ow
Ow
Ow
Ow
Ow
Ow
Ow
Ow
Ow
"}
(50,1,1) = {"
Ow
Ow
Ow
Ow
Ow
Ow
Ow
Ow
Ow
Ow
Ow
Ow
Ow
Ow
Ow
Ow
Ow
Ow
Ow
Ow
Ow
Ow
Ow
Ow
Ow
Ow
Ow
Ow
Ow
Ow
Ow
Ow
Ow
Ow
Ow
Ow
Ow
Ow
Ow
Ow
Ow
Ow
Ow
Ow
Ow
Ow
Ow
Ow
Ow
Ow
"}
