//MAP CONVERTED BY dmm2tgm.py THIS HEADER COMMENT PREVENTS RECONVERSION, DO NOT REMOVE
"bC" = (
/mob/living/simple_animal/hostile/ordeal/indigo_dawn{
	name = "sweeper scout"
	},
/turf/open/floor/plating,
/area/city/backstreets_room)
"kc" = (
/obj/item/folder/syndicate/blue{
	desc = "You have a feeling that these series of documents within this folder are not for the average person to gaze at.";
	name = "Highly Confidential Folder"
	},
/turf/open/floor/plating,
/area/city/backstreets_room)
"mA" = (
/obj/item/folder/syndicate/red{
	desc = "A folder belonging to one of the City's corporations.";
	name = "Corporation Folder"
	},
/turf/open/floor/plating,
/area/city/backstreets_room)
"sP" = (
/mob/living/simple_animal/hostile/ordeal/green_bot{
	name = "guard bot"
	},
/turf/open/floor/plating,
/area/city/backstreets_room)
"tF" = (
/mob/living/simple_animal/hostile/ordeal/green_bot{
	name = "clerk bot"
	},
/turf/open/floor/plating,
/area/city/backstreets_room)
"wu" = (
/mob/living/simple_animal/hostile/ordeal/green_bot{
	name = "spear bot"
	},
/turf/open/floor/plating,
/area/city/backstreets_room)
"wG" = (
/mob/living/simple_animal/hostile/ordeal/green_bot_big{
	name = "gun bot"
	},
/turf/open/floor/plating,
/area/city/backstreets_room)
"zZ" = (
/turf/closed/indestructible/reinforced,
/area/city/backstreets_room)
"AX" = (
/mob/living/simple_animal/hostile/ordeal/amber_bug{
	name = "carnivorous worm"
	},
/turf/open/floor/plating,
/area/city/backstreets_room)
"BJ" = (
/obj/item/folder/blue{
	desc = "Appears to be permits and documents of an unspecified workshop.";
	name = "Workshop Folder"
	},
/turf/open/floor/plating,
/area/city/backstreets_room)
"Dd" = (
/obj/item/folder/white{
	desc = "Looks to be remnants of the old G-Corp.";
	name = "Outdated G-Corp Folder"
	},
/turf/open/floor/plating,
/area/city/backstreets_room)
"Hb" = (
/mob/living/simple_animal/hostile/ordeal/indigo_noon,
/turf/open/floor/plating,
/area/city/backstreets_room)
"ZW" = (
/turf/open/floor/plating,
/area/city/backstreets_room)

(1,1,1) = {"
zZ
zZ
zZ
zZ
zZ
zZ
zZ
zZ
zZ
zZ
zZ
zZ
zZ
zZ
zZ
zZ
zZ
zZ
zZ
zZ
zZ
zZ
zZ
zZ
zZ
zZ
zZ
zZ
zZ
zZ
"}
(2,1,1) = {"
zZ
ZW
ZW
ZW
ZW
ZW
ZW
ZW
ZW
ZW
ZW
ZW
ZW
ZW
ZW
ZW
ZW
ZW
ZW
ZW
ZW
ZW
ZW
ZW
ZW
ZW
ZW
ZW
ZW
zZ
"}
(3,1,1) = {"
zZ
ZW
ZW
ZW
ZW
ZW
ZW
ZW
ZW
ZW
ZW
ZW
ZW
ZW
ZW
ZW
ZW
ZW
ZW
ZW
ZW
ZW
ZW
ZW
ZW
ZW
ZW
ZW
ZW
zZ
"}
(4,1,1) = {"
zZ
ZW
ZW
zZ
zZ
zZ
zZ
zZ
zZ
zZ
zZ
zZ
zZ
zZ
zZ
zZ
zZ
zZ
zZ
zZ
zZ
zZ
zZ
zZ
zZ
zZ
zZ
ZW
ZW
zZ
"}
(5,1,1) = {"
zZ
ZW
ZW
zZ
ZW
ZW
ZW
ZW
ZW
ZW
ZW
ZW
ZW
ZW
ZW
ZW
ZW
ZW
ZW
ZW
ZW
ZW
ZW
ZW
ZW
ZW
zZ
ZW
ZW
zZ
"}
(6,1,1) = {"
zZ
ZW
ZW
zZ
ZW
ZW
ZW
ZW
ZW
ZW
ZW
ZW
ZW
ZW
ZW
ZW
ZW
ZW
ZW
ZW
ZW
ZW
ZW
ZW
ZW
ZW
zZ
ZW
ZW
zZ
"}
(7,1,1) = {"
zZ
ZW
ZW
zZ
ZW
ZW
ZW
ZW
ZW
ZW
ZW
ZW
ZW
ZW
ZW
ZW
ZW
ZW
ZW
ZW
ZW
ZW
ZW
ZW
ZW
ZW
zZ
ZW
ZW
zZ
"}
(8,1,1) = {"
zZ
ZW
ZW
zZ
ZW
ZW
ZW
ZW
ZW
ZW
ZW
ZW
ZW
ZW
ZW
ZW
ZW
ZW
ZW
ZW
ZW
ZW
ZW
ZW
ZW
ZW
zZ
ZW
ZW
zZ
"}
(9,1,1) = {"
zZ
ZW
ZW
zZ
ZW
ZW
ZW
ZW
ZW
ZW
ZW
ZW
ZW
ZW
ZW
ZW
ZW
ZW
ZW
ZW
ZW
ZW
ZW
ZW
ZW
ZW
zZ
ZW
ZW
zZ
"}
(10,1,1) = {"
zZ
ZW
ZW
zZ
ZW
ZW
ZW
ZW
ZW
ZW
ZW
ZW
ZW
ZW
ZW
ZW
ZW
ZW
ZW
ZW
ZW
ZW
ZW
ZW
ZW
ZW
zZ
ZW
ZW
zZ
"}
(11,1,1) = {"
zZ
ZW
ZW
zZ
ZW
ZW
ZW
ZW
ZW
ZW
ZW
ZW
ZW
ZW
ZW
ZW
ZW
ZW
ZW
ZW
ZW
ZW
ZW
ZW
ZW
ZW
zZ
ZW
ZW
zZ
"}
(12,1,1) = {"
zZ
ZW
ZW
zZ
ZW
ZW
ZW
ZW
ZW
ZW
ZW
ZW
ZW
kc
ZW
ZW
BJ
ZW
ZW
ZW
ZW
ZW
ZW
ZW
ZW
ZW
zZ
ZW
ZW
zZ
"}
(13,1,1) = {"
zZ
ZW
ZW
zZ
ZW
ZW
ZW
ZW
ZW
ZW
ZW
ZW
ZW
ZW
ZW
ZW
ZW
ZW
ZW
ZW
ZW
ZW
ZW
ZW
ZW
ZW
zZ
ZW
ZW
zZ
"}
(14,1,1) = {"
zZ
ZW
ZW
zZ
ZW
ZW
ZW
ZW
ZW
ZW
ZW
ZW
ZW
mA
ZW
ZW
Dd
ZW
ZW
ZW
ZW
ZW
ZW
ZW
ZW
ZW
zZ
ZW
ZW
zZ
"}
(15,1,1) = {"
zZ
ZW
ZW
zZ
ZW
ZW
ZW
ZW
ZW
ZW
ZW
ZW
ZW
ZW
ZW
ZW
ZW
ZW
ZW
ZW
ZW
ZW
ZW
ZW
ZW
ZW
zZ
ZW
ZW
zZ
"}
(16,1,1) = {"
zZ
ZW
ZW
zZ
ZW
ZW
ZW
ZW
ZW
ZW
ZW
ZW
ZW
ZW
ZW
ZW
ZW
ZW
ZW
ZW
ZW
ZW
ZW
ZW
ZW
ZW
zZ
ZW
ZW
zZ
"}
(17,1,1) = {"
zZ
ZW
ZW
zZ
ZW
ZW
ZW
ZW
ZW
ZW
ZW
ZW
ZW
tF
ZW
ZW
ZW
ZW
ZW
ZW
ZW
ZW
ZW
ZW
ZW
ZW
zZ
ZW
ZW
zZ
"}
(18,1,1) = {"
zZ
ZW
ZW
zZ
ZW
ZW
ZW
ZW
ZW
ZW
ZW
ZW
ZW
ZW
ZW
wG
ZW
ZW
bC
ZW
ZW
ZW
ZW
ZW
ZW
ZW
zZ
ZW
ZW
zZ
"}
(19,1,1) = {"
zZ
ZW
ZW
zZ
ZW
ZW
ZW
ZW
ZW
ZW
ZW
ZW
ZW
sP
ZW
ZW
ZW
ZW
ZW
ZW
ZW
ZW
ZW
ZW
ZW
ZW
zZ
ZW
ZW
zZ
"}
(20,1,1) = {"
zZ
ZW
ZW
zZ
ZW
ZW
ZW
ZW
ZW
ZW
ZW
ZW
ZW
ZW
ZW
AX
ZW
ZW
Hb
ZW
ZW
ZW
ZW
ZW
ZW
ZW
zZ
ZW
ZW
zZ
"}
(21,1,1) = {"
zZ
ZW
ZW
zZ
ZW
ZW
ZW
ZW
ZW
ZW
ZW
ZW
ZW
wu
ZW
ZW
ZW
ZW
ZW
ZW
ZW
ZW
ZW
ZW
ZW
ZW
zZ
ZW
ZW
zZ
"}
(22,1,1) = {"
zZ
ZW
ZW
zZ
ZW
ZW
ZW
ZW
ZW
ZW
ZW
ZW
ZW
ZW
ZW
ZW
ZW
ZW
ZW
ZW
ZW
ZW
ZW
ZW
ZW
ZW
zZ
ZW
ZW
zZ
"}
(23,1,1) = {"
zZ
ZW
ZW
zZ
ZW
ZW
ZW
ZW
ZW
ZW
ZW
ZW
ZW
ZW
ZW
ZW
ZW
ZW
ZW
ZW
ZW
ZW
ZW
ZW
ZW
ZW
zZ
ZW
ZW
zZ
"}
(24,1,1) = {"
zZ
ZW
ZW
zZ
ZW
ZW
ZW
ZW
ZW
ZW
ZW
ZW
ZW
ZW
ZW
ZW
ZW
ZW
ZW
ZW
ZW
ZW
ZW
ZW
ZW
ZW
zZ
ZW
ZW
zZ
"}
(25,1,1) = {"
zZ
ZW
ZW
zZ
ZW
ZW
ZW
ZW
ZW
ZW
ZW
ZW
ZW
ZW
ZW
ZW
ZW
ZW
ZW
ZW
ZW
ZW
ZW
ZW
ZW
ZW
zZ
ZW
ZW
zZ
"}
(26,1,1) = {"
zZ
ZW
ZW
zZ
ZW
ZW
ZW
ZW
ZW
ZW
ZW
ZW
ZW
ZW
ZW
ZW
ZW
ZW
ZW
ZW
ZW
ZW
ZW
ZW
ZW
ZW
zZ
ZW
ZW
zZ
"}
(27,1,1) = {"
zZ
ZW
ZW
zZ
zZ
zZ
zZ
zZ
zZ
zZ
zZ
zZ
zZ
zZ
zZ
zZ
zZ
zZ
zZ
zZ
zZ
zZ
zZ
zZ
zZ
zZ
zZ
ZW
ZW
zZ
"}
(28,1,1) = {"
zZ
ZW
ZW
ZW
ZW
ZW
ZW
ZW
ZW
ZW
ZW
ZW
ZW
ZW
ZW
ZW
ZW
ZW
ZW
ZW
ZW
ZW
ZW
ZW
ZW
ZW
ZW
ZW
ZW
zZ
"}
(29,1,1) = {"
zZ
ZW
ZW
ZW
ZW
ZW
ZW
ZW
ZW
ZW
ZW
ZW
ZW
ZW
ZW
ZW
ZW
ZW
ZW
ZW
ZW
ZW
ZW
ZW
ZW
ZW
ZW
ZW
ZW
zZ
"}
(30,1,1) = {"
zZ
zZ
zZ
zZ
zZ
zZ
zZ
zZ
zZ
zZ
zZ
zZ
zZ
zZ
zZ
zZ
zZ
zZ
zZ
zZ
zZ
zZ
zZ
zZ
zZ
zZ
zZ
zZ
zZ
zZ
"}
