//MAP CONVERTED BY dmm2tgm.py THIS HEADER COMMENT PREVENTS RECONVERSION, DO NOT REMOVE
"a" = (
/turf/template_noop,
/area/template_noop)
"o" = (
/obj/machinery/computer/operating,
/obj/effect/turf_decal/tile/blue{
	dir = 1;
	icon_state = "tile_corner"
	},
/obj/effect/turf_decal/tile/blue{
	dir = 4;
	icon_state = "tile_corner"
	},
/obj/effect/turf_decal/tile/blue{
	dir = 8;
	icon_state = "tile_corner"
	},
/turf/open/floor/plasteel/white,
/area/template_noop)
"t" = (
/obj/effect/turf_decal/tile/blue{
	dir = 1;
	icon_state = "tile_corner"
	},
/obj/effect/turf_decal/tile/blue{
	dir = 8;
	icon_state = "tile_corner"
	},
/obj/machinery/button/door{
	id = "fswindow4";
	name = "window shutters";
	pixel_x = -26;
	pixel_y = 26;
	req_one_access_txt = "150"
	},
/turf/open/floor/plasteel/white,
/area/template_noop)
"B" = (
/obj/effect/turf_decal/tile/blue,
/obj/effect/turf_decal/tile/blue{
	dir = 8;
	icon_state = "tile_corner"
	},
/turf/open/floor/plasteel/white,
/area/template_noop)
"E" = (
/obj/machinery/door/airlock/grunge{
	name = "Syndicate Ship Airlock";
	req_one_access_txt = "150"
	},
/turf/open/floor/plasteel/white,
/area/template_noop)
"G" = (
/obj/effect/turf_decal/tile/blue{
	dir = 1;
	icon_state = "tile_corner"
	},
/obj/effect/turf_decal/tile/blue{
	dir = 4;
	icon_state = "tile_corner"
	},
/obj/machinery/stasis,
/turf/open/floor/plasteel/white,
/area/template_noop)
"H" = (
/obj/item/storage/backpack/duffelbag/syndie/surgery{
	layer = 3.001
	},
/obj/structure/table,
/obj/effect/turf_decal/tile/blue{
	dir = 1;
	icon_state = "tile_corner"
	},
/obj/effect/turf_decal/tile/blue{
	dir = 4;
	icon_state = "tile_corner"
	},
/obj/effect/turf_decal/tile/blue,
/obj/item/reagent_containers/glass/bottle/formaldehyde{
	pixel_x = 8;
	pixel_y = 10
	},
/obj/item/reagent_containers/syringe{
	pixel_x = -4;
	pixel_y = 8
	},
/turf/open/floor/plasteel/white,
/area/template_noop)
"J" = (
/obj/effect/turf_decal/tile/blue{
	dir = 4;
	icon_state = "tile_corner"
	},
/obj/effect/turf_decal/tile/blue,
/obj/effect/turf_decal/tile/blue{
	dir = 8;
	icon_state = "tile_corner"
	},
/turf/open/floor/plasteel/white,
/area/template_noop)
"M" = (
/obj/effect/turf_decal/tile/blue{
	dir = 1;
	icon_state = "tile_corner"
	},
/obj/effect/turf_decal/tile/blue{
	dir = 8;
	icon_state = "tile_corner"
	},
/turf/open/floor/plasteel/white,
/area/template_noop)
"S" = (
/obj/effect/turf_decal/tile/blue{
	dir = 4;
	icon_state = "tile_corner"
	},
/obj/effect/turf_decal/tile/blue,
/obj/machinery/light/small{
	dir = 4;
	icon_state = "bulb"
	},
/turf/open/floor/plasteel/white,
/area/template_noop)
"W" = (
/obj/machinery/vending/medical/syndicate_access/cybersun,
/obj/effect/turf_decal/tile/blue{
	dir = 1;
	icon_state = "tile_corner"
	},
/obj/effect/turf_decal/tile/blue,
/obj/effect/turf_decal/tile/blue{
	dir = 8;
	icon_state = "tile_corner"
	},
/turf/open/floor/plasteel/white,
/area/template_noop)
"X" = (
/turf/open/floor/plasteel/white,
/area/template_noop)
"Y" = (
/obj/machinery/camera/xray{
	c_tag = "Medbay";
	dir = 9;
	name = "security camera";
	network = list("fsci");
	screen_loc = ""
	},
/obj/effect/turf_decal/tile/blue{
	dir = 4;
	icon_state = "tile_corner"
	},
/obj/effect/turf_decal/tile/blue,
/turf/open/floor/plasteel/white,
/area/template_noop)

(1,1,1) = {"
o
t
M
W
a
"}
(2,1,1) = {"
G
X
X
B
a
"}
(3,1,1) = {"
H
Y
S
J
E
"}
