//MAP CONVERTED BY dmm2tgm.py THIS HEADER COMMENT PREVENTS RECONVERSION, DO NOT REMOVE
"a" = (
/turf/closed/indestructible/riveted/boss,
/area/lor/arena)
"b" = (
/turf/open/floor/mineral/uranium{
	density = 1;
	desc = "You can see a bunch of plants in the distance";
	name = "forest background"
	},
/area/lor/arena)
"c" = (
/turf/open/floor/grass,
/area/lor/arena)
"d" = (
/obj/effect/landmark/library_reception_humans,
/turf/open/floor/grass,
/area/lor/arena)
"e" = (
/obj/effect/landmark/library_reception_abno,
/turf/open/floor/grass,
/area/lor/arena)
"f" = (
/obj/structure/bookcase,
/turf/open/floor/plasteel/rockvault/sandstone{
	density = 1;
	desc = "A giant tree converted into bookshelves";
	name = "treeshelf"
	},
/area/lor/arena)
"g" = (
/turf/open/floor/plasteel/rockvault/sandstone{
	density = 1;
	desc = "A giant tree converted into bookshelves";
	name = "treeshelf"
	},
/area/lor/arena)
"h" = (
/turf/open/floor/wood,
/area/lor/arena)

(1,1,1) = {"
a
a
a
a
a
a
a
a
a
a
a
a
a
a
a
a
a
a
a
a
a
"}
(2,1,1) = {"
a
b
b
b
b
b
h
c
c
c
c
c
c
c
c
c
h
b
b
b
a
"}
(3,1,1) = {"
a
b
b
b
b
b
h
c
c
c
c
c
c
c
c
c
h
b
b
b
a
"}
(4,1,1) = {"
a
b
b
b
b
b
h
c
c
c
c
c
c
c
c
c
h
b
b
b
a
"}
(5,1,1) = {"
a
f
g
g
g
g
h
c
c
d
c
c
c
d
c
c
h
g
f
g
a
"}
(6,1,1) = {"
a
f
g
g
f
g
h
c
c
c
c
c
c
c
c
c
h
g
g
f
a
"}
(7,1,1) = {"
a
g
g
g
g
g
h
c
c
c
c
d
c
c
c
c
h
g
g
g
a
"}
(8,1,1) = {"
a
g
g
f
g
g
h
c
c
c
c
c
c
c
c
c
h
g
f
g
a
"}
(9,1,1) = {"
a
b
b
b
b
b
h
c
c
d
c
c
c
d
c
c
h
b
b
b
a
"}
(10,1,1) = {"
a
b
b
b
b
b
h
c
c
c
c
c
c
c
c
c
h
b
b
b
a
"}
(11,1,1) = {"
a
b
b
b
b
b
h
c
c
c
c
c
c
c
c
c
h
b
b
b
a
"}
(12,1,1) = {"
a
b
b
b
b
b
h
c
c
c
c
c
c
c
c
c
h
b
b
b
a
"}
(13,1,1) = {"
a
b
b
b
b
b
h
c
c
c
c
c
c
c
c
c
h
b
b
b
a
"}
(14,1,1) = {"
a
b
b
b
b
b
h
c
c
c
c
c
c
c
c
c
h
b
b
b
a
"}
(15,1,1) = {"
a
f
g
g
f
g
h
c
c
e
c
c
c
e
c
c
h
g
g
f
a
"}
(16,1,1) = {"
a
g
f
g
f
g
h
c
c
c
c
c
c
c
c
c
h
g
g
g
a
"}
(17,1,1) = {"
a
g
g
g
g
g
h
c
c
c
c
e
c
c
c
c
h
g
f
g
a
"}
(18,1,1) = {"
a
f
g
f
g
g
h
c
c
c
c
c
c
c
c
c
h
g
g
f
a
"}
(19,1,1) = {"
a
g
g
f
g
g
h
c
c
e
c
c
c
e
c
c
h
g
f
g
a
"}
(20,1,1) = {"
a
b
b
b
b
b
h
c
c
c
c
c
c
c
c
c
h
b
b
b
a
"}
(21,1,1) = {"
a
b
b
b
b
b
h
c
c
c
c
c
c
c
c
c
h
b
b
b
a
"}
(22,1,1) = {"
a
b
b
b
b
b
h
c
c
c
c
c
c
c
c
c
h
b
b
b
a
"}
(23,1,1) = {"
a
a
a
a
a
a
a
a
a
a
a
a
a
a
a
a
a
a
a
a
a
"}
