//MAP CONVERTED BY dmm2tgm.py THIS HEADER COMMENT PREVENTS RECONVERSION, DO NOT REMOVE
"a" = (
/turf/closed/indestructible/riveted/boss,
/area/lor/arena)
"b" = (
/turf/open/floor/plating/dirt/dark{
	density = 1;
	desc = "a towering stacks of books.";
	name = "book tower"
	},
/area/lor/arena)
"c" = (
/turf/open/floor/grass/fakebasalt,
/area/lor/arena)
"d" = (
/turf/open/floor/mineral/plastitanium,
/area/lor/arena)
"e" = (
/obj/effect/landmark/library_reception_humans,
/turf/open/floor/mineral/plastitanium,
/area/lor/arena)
"f" = (
/obj/effect/landmark/library_reception_abno,
/turf/open/floor/mineral/plastitanium,
/area/lor/arena)
"g" = (
/turf/open/floor/black{
	density = 1;
	desc = "You can't see the bottom of the stacked books";
	name = "void of books"
	},
/area/lor/arena)
"h" = (
/turf/open/floor/facility/halls{
	density = 1;
	desc = "infinite bookshelves decorate the library walls";
	name = "distant bookshelves"
	},
/area/lor/arena)

(1,1,1) = {"
a
a
a
a
a
a
a
a
a
a
a
a
a
a
a
a
a
a
a
a
a
"}
(2,1,1) = {"
a
b
b
b
h
h
c
d
d
d
d
d
d
d
d
d
c
g
g
g
a
"}
(3,1,1) = {"
a
b
b
b
b
b
c
d
d
d
d
d
d
d
d
d
c
g
g
g
a
"}
(4,1,1) = {"
a
h
b
b
b
b
c
d
d
d
d
d
d
d
d
d
c
g
g
g
a
"}
(5,1,1) = {"
a
h
h
b
b
b
c
d
d
e
d
d
d
e
d
d
c
g
g
g
a
"}
(6,1,1) = {"
a
h
h
h
b
b
c
d
d
d
d
d
d
d
d
d
c
g
g
g
a
"}
(7,1,1) = {"
a
h
h
h
h
b
c
d
d
d
d
e
d
d
d
d
c
g
g
g
a
"}
(8,1,1) = {"
a
h
h
h
h
h
c
d
d
d
d
d
d
d
d
d
c
g
g
g
a
"}
(9,1,1) = {"
a
h
h
h
h
b
c
d
d
e
d
d
d
e
d
d
c
g
g
g
a
"}
(10,1,1) = {"
a
b
b
h
b
b
c
d
d
d
d
d
d
d
d
d
c
g
g
g
a
"}
(11,1,1) = {"
a
h
b
b
b
b
c
d
d
d
d
d
d
d
d
d
c
g
g
g
a
"}
(12,1,1) = {"
a
h
h
b
h
b
c
d
d
d
d
d
d
d
d
d
c
g
g
g
a
"}
(13,1,1) = {"
a
h
h
h
h
h
c
d
d
d
d
d
d
d
d
d
c
g
g
g
a
"}
(14,1,1) = {"
a
h
h
h
h
b
c
d
d
d
d
d
d
d
d
d
c
g
g
g
a
"}
(15,1,1) = {"
a
h
h
h
b
b
c
d
d
f
d
d
d
f
d
d
c
g
g
g
a
"}
(16,1,1) = {"
a
b
h
b
b
b
c
d
d
d
d
d
d
d
d
d
c
g
g
g
a
"}
(17,1,1) = {"
a
h
b
b
b
h
c
d
d
d
d
f
d
d
d
d
c
g
g
g
a
"}
(18,1,1) = {"
a
h
h
h
h
h
c
d
d
d
d
d
d
d
d
d
c
g
g
g
a
"}
(19,1,1) = {"
a
h
h
h
h
h
c
d
d
f
d
d
d
f
d
d
c
g
g
g
a
"}
(20,1,1) = {"
a
h
b
h
b
b
c
d
d
d
d
d
d
d
d
d
c
g
g
g
a
"}
(21,1,1) = {"
a
b
b
b
b
b
c
d
d
d
d
d
d
d
d
d
c
g
g
g
a
"}
(22,1,1) = {"
a
b
h
b
h
b
c
d
d
d
d
d
d
d
d
d
c
g
g
g
a
"}
(23,1,1) = {"
a
a
a
a
a
a
a
a
a
a
a
a
a
a
a
a
a
a
a
a
a
"}
