//MAP CONVERTED BY dmm2tgm.py THIS HEADER COMMENT PREVENTS RECONVERSION, DO NOT REMOVE
"a" = (
/turf/closed/indestructible/riveted/boss,
/area/lor/arena)
"b" = (
/turf/open/floor/mineral/titanium/yellow{
	density = 1;
	desc = "bright lights are shining over the distance";
	name = "shining lights"
	},
/area/lor/arena)
"c" = (
/turf/open/floor/plating/dirt/jungle/wasteland{
	density = 1
	},
/area/lor/arena)
"d" = (
/turf/open/floor/bronze{
	density = 1
	},
/area/lor/arena)
"e" = (
/turf/open/floor/bronze,
/area/lor/arena)
"f" = (
/obj/effect/landmark/library_reception_humans,
/turf/open/floor/bronze,
/area/lor/arena)
"g" = (
/obj/effect/landmark/library_reception_abno,
/turf/open/floor/bronze,
/area/lor/arena)
"h" = (
/obj/structure/displaycase/trophy,
/turf/open/floor/plating/dirt/jungle/wasteland{
	density = 1
	},
/area/lor/arena)
"i" = (
/turf/open/floor/plating/ironsand{
	density = 1;
	desc = "a giant gear tower looming over the distance";
	name = "gear tower"
	},
/area/lor/arena)

(1,1,1) = {"
a
a
a
a
a
a
a
a
a
a
a
a
a
a
a
a
a
a
a
a
a
"}
(2,1,1) = {"
a
b
b
c
d
h
e
e
e
e
e
e
e
e
e
e
e
c
d
h
a
"}
(3,1,1) = {"
a
b
b
h
e
c
e
e
e
e
e
e
e
e
e
e
e
h
e
c
a
"}
(4,1,1) = {"
a
b
b
c
e
h
e
e
e
e
e
e
e
e
e
e
e
c
e
h
a
"}
(5,1,1) = {"
a
b
b
h
e
c
e
e
e
f
e
e
e
f
e
e
e
h
e
c
a
"}
(6,1,1) = {"
a
b
b
c
e
h
e
e
e
e
e
e
e
e
e
e
e
c
e
h
a
"}
(7,1,1) = {"
a
b
b
h
e
c
e
e
e
e
e
f
e
e
e
e
e
h
e
c
a
"}
(8,1,1) = {"
a
b
b
c
e
h
e
e
e
e
e
e
e
e
e
e
e
c
e
h
a
"}
(9,1,1) = {"
a
b
b
h
e
c
e
e
e
f
e
e
e
f
e
e
e
h
e
c
a
"}
(10,1,1) = {"
a
i
i
i
i
h
e
e
e
e
e
e
e
e
e
e
e
c
e
h
a
"}
(11,1,1) = {"
a
i
i
i
i
c
e
e
e
e
e
e
e
e
e
e
e
h
e
c
a
"}
(12,1,1) = {"
a
i
i
i
i
h
e
e
e
e
e
e
e
e
e
e
e
c
e
h
a
"}
(13,1,1) = {"
a
i
i
i
i
c
e
e
e
e
e
e
e
e
e
e
e
h
e
c
a
"}
(14,1,1) = {"
a
b
b
c
e
h
e
e
e
e
e
e
e
e
e
e
e
c
e
h
a
"}
(15,1,1) = {"
a
b
b
h
e
c
e
e
e
g
e
e
e
g
e
e
e
h
e
c
a
"}
(16,1,1) = {"
a
b
b
c
e
h
e
e
e
e
e
e
e
e
e
e
e
c
e
h
a
"}
(17,1,1) = {"
a
b
b
h
e
c
e
e
e
e
e
g
e
e
e
e
e
h
e
c
a
"}
(18,1,1) = {"
a
b
b
c
e
h
e
e
e
e
e
e
e
e
e
e
e
c
e
h
a
"}
(19,1,1) = {"
a
b
b
h
e
c
e
e
e
g
e
e
e
g
e
e
e
h
e
c
a
"}
(20,1,1) = {"
a
b
b
c
e
h
e
e
e
e
e
e
e
e
e
e
e
c
e
h
a
"}
(21,1,1) = {"
a
b
b
h
e
c
e
e
e
e
e
e
e
e
e
e
e
h
e
c
a
"}
(22,1,1) = {"
a
b
b
c
e
h
e
e
e
e
e
e
e
e
e
e
e
c
e
h
a
"}
(23,1,1) = {"
a
a
a
a
a
a
a
a
a
a
a
a
a
a
a
a
a
a
a
a
a
"}
