//MAP CONVERTED BY dmm2tgm.py THIS HEADER COMMENT PREVENTS RECONVERSION, DO NOT REMOVE
"a" = (
/turf/closed/indestructible/riveted/boss,
/area/lor/arena)
"b" = (
/turf/open/floor/mineral/plastitanium/red{
	density = 1;
	desc = "you can't see far in this heat";
	name = "hazy background"
	},
/area/lor/arena)
"c" = (
/turf/open/floor/mineral/titanium,
/area/lor/arena)
"d" = (
/turf/open/floor/mineral/titanium/white,
/area/lor/arena)
"e" = (
/obj/effect/landmark/library_reception_humans,
/turf/open/floor/mineral/titanium/white,
/area/lor/arena)
"f" = (
/turf/open/lava/smooth{
	density = 1
	},
/area/lor/arena)
"g" = (
/turf/open/lava{
	density = 1
	},
/area/lor/arena)
"h" = (
/turf/open/floor/mineral/titanium/yellow{
	density = 1;
	desc = "a waste pipe pumping out lava";
	name = "waste exhaust"
	},
/area/lor/arena)
"i" = (
/turf/open/floor/bronze{
	density = 1;
	desc = "towering metal structures looming over the floor";
	name = "metal tower"
	},
/area/lor/arena)
"j" = (
/obj/effect/landmark/library_reception_abno,
/turf/open/floor/mineral/titanium/white,
/area/lor/arena)

(1,1,1) = {"
a
a
a
a
a
a
a
a
a
a
a
a
a
a
a
a
a
a
a
a
a
"}
(2,1,1) = {"
a
b
b
b
b
b
c
d
d
d
d
d
d
d
d
d
c
f
f
g
a
"}
(3,1,1) = {"
a
i
i
i
i
i
c
d
d
d
d
d
d
d
d
d
c
f
f
g
a
"}
(4,1,1) = {"
a
i
i
i
i
i
c
d
d
d
d
d
d
d
d
d
c
f
f
g
a
"}
(5,1,1) = {"
a
i
i
i
i
i
c
d
d
e
d
d
d
e
d
d
c
f
f
g
a
"}
(6,1,1) = {"
a
b
b
b
b
b
c
d
d
d
d
d
d
d
d
d
c
f
f
g
a
"}
(7,1,1) = {"
a
b
b
b
b
b
c
d
d
d
d
e
d
d
d
d
c
f
f
g
a
"}
(8,1,1) = {"
a
b
b
b
b
b
c
d
d
d
d
d
d
d
d
d
c
f
f
g
a
"}
(9,1,1) = {"
a
i
i
i
i
i
c
d
d
e
d
d
d
e
d
d
c
f
f
g
a
"}
(10,1,1) = {"
a
i
h
h
h
f
c
d
d
d
d
d
d
d
d
d
c
f
f
g
a
"}
(11,1,1) = {"
a
i
h
h
h
f
c
d
d
d
d
d
d
d
d
d
c
f
f
g
a
"}
(12,1,1) = {"
a
i
h
h
h
f
c
d
d
d
d
d
d
d
d
d
c
f
f
g
a
"}
(13,1,1) = {"
a
i
i
i
i
i
c
d
d
d
d
d
d
d
d
d
c
f
f
g
a
"}
(14,1,1) = {"
a
i
i
i
i
i
c
d
d
d
d
d
d
d
d
d
c
f
f
g
a
"}
(15,1,1) = {"
a
b
b
b
b
b
c
d
d
j
d
d
d
j
d
d
c
f
f
g
a
"}
(16,1,1) = {"
a
b
b
b
b
b
c
d
d
d
d
d
d
d
d
d
c
f
f
g
a
"}
(17,1,1) = {"
a
i
i
i
i
i
c
d
d
d
d
j
d
d
d
d
c
f
f
g
a
"}
(18,1,1) = {"
a
i
i
i
i
i
c
d
d
d
d
d
d
d
d
d
c
f
f
g
a
"}
(19,1,1) = {"
a
i
i
i
i
i
c
d
d
j
d
d
d
j
d
d
c
f
f
g
a
"}
(20,1,1) = {"
a
i
i
i
i
i
c
d
d
d
d
d
d
d
d
d
c
f
f
g
a
"}
(21,1,1) = {"
a
i
i
i
i
i
c
d
d
d
d
d
d
d
d
d
c
f
f
g
a
"}
(22,1,1) = {"
a
b
b
b
b
b
c
d
d
d
d
d
d
d
d
d
c
f
f
g
a
"}
(23,1,1) = {"
a
a
a
a
a
a
a
a
a
a
a
a
a
a
a
a
a
a
a
a
a
"}
