//MAP CONVERTED BY dmm2tgm.py THIS HEADER COMMENT PREVENTS RECONVERSION, DO NOT REMOVE
"a" = (
/turf/closed/indestructible/riveted/boss,
/area/lor/arena)
"b" = (
/turf/open/floor/mineral/titanium/tiled/blue,
/area/lor/arena)
"c" = (
/obj/structure/railing{
	name = "invincible railing";
	resistance_flags = 64
	},
/turf/open/floor/wood{
	density = 1
	},
/area/lor/arena)
"d" = (
/turf/open/floor/wood,
/area/lor/arena)
"e" = (
/obj/effect/landmark/library_reception_humans,
/turf/open/floor/wood,
/area/lor/arena)
"f" = (
/obj/effect/landmark/library_reception_abno,
/turf/open/floor/wood,
/area/lor/arena)
"g" = (
/obj/structure/railing{
	dir = 1;
	name = "invincible railing";
	resistance_flags = 64
	},
/turf/open/floor/wood{
	density = 1
	},
/area/lor/arena)
"h" = (
/turf/open/floor/bronze{
	density = 1;
	desc = "towering metal structures looming over the floor";
	name = "metal tower"
	},
/area/lor/arena)
"i" = (
/obj/structure/bookcase,
/turf/open/floor/mineral/titanium/tiled/blue,
/area/lor/arena)
"j" = (
/obj/structure/bookcase,
/turf/open/floor/mineral/titanium/tiled/blue{
	density = 1;
	name = "blue background"
	},
/area/lor/arena)

(1,1,1) = {"
a
a
a
a
a
a
a
a
a
a
a
a
a
a
a
a
a
a
a
a
a
"}
(2,1,1) = {"
a
b
i
b
j
c
d
d
d
d
d
d
d
d
d
d
d
g
b
i
a
"}
(3,1,1) = {"
a
h
h
h
h
c
d
d
d
d
d
d
d
d
d
d
d
g
h
h
a
"}
(4,1,1) = {"
a
h
h
h
h
c
d
d
d
d
d
d
d
d
d
d
d
g
h
h
a
"}
(5,1,1) = {"
a
b
b
b
i
c
d
d
d
e
d
d
d
e
d
d
d
g
b
b
a
"}
(6,1,1) = {"
a
i
b
i
b
c
d
d
d
d
d
d
d
d
d
d
d
g
i
b
a
"}
(7,1,1) = {"
a
b
i
b
b
c
d
d
d
d
d
e
d
d
d
d
d
g
b
i
a
"}
(8,1,1) = {"
a
i
b
i
b
c
d
d
d
d
d
d
d
d
d
d
d
g
b
b
a
"}
(9,1,1) = {"
a
b
b
b
i
c
d
d
d
e
d
d
d
e
d
d
d
g
b
i
a
"}
(10,1,1) = {"
a
i
b
b
b
c
d
d
d
d
d
d
d
d
d
d
d
g
i
b
a
"}
(11,1,1) = {"
a
h
h
h
h
c
d
d
d
d
d
d
d
d
d
d
d
g
h
h
a
"}
(12,1,1) = {"
a
h
h
h
h
c
d
d
d
d
d
d
d
d
d
d
d
g
h
h
a
"}
(13,1,1) = {"
a
h
h
h
h
c
d
d
d
d
d
d
d
d
d
d
d
g
h
h
a
"}
(14,1,1) = {"
a
h
h
h
h
c
d
d
d
d
d
d
d
d
d
d
d
g
h
h
a
"}
(15,1,1) = {"
a
b
b
i
b
c
d
d
d
f
d
d
d
f
d
d
d
g
b
i
a
"}
(16,1,1) = {"
a
b
i
b
i
c
d
d
d
d
d
d
d
d
d
d
d
g
i
b
a
"}
(17,1,1) = {"
a
i
b
b
b
c
d
d
d
d
d
f
d
d
d
d
d
g
b
b
a
"}
(18,1,1) = {"
a
b
i
b
i
c
d
d
d
d
d
d
d
d
d
d
d
g
b
i
a
"}
(19,1,1) = {"
a
h
h
h
h
c
d
d
d
f
d
d
d
f
d
d
d
g
h
h
a
"}
(20,1,1) = {"
a
h
h
h
h
c
d
d
d
d
d
d
d
d
d
d
d
g
h
h
a
"}
(21,1,1) = {"
a
i
b
i
b
c
d
d
d
d
d
d
d
d
d
d
d
g
i
b
a
"}
(22,1,1) = {"
a
b
b
b
i
c
d
d
d
d
d
d
d
d
d
d
d
g
b
i
a
"}
(23,1,1) = {"
a
a
a
a
a
a
a
a
a
a
a
a
a
a
a
a
a
a
a
a
a
"}
