//MAP CONVERTED BY dmm2tgm.py THIS HEADER COMMENT PREVENTS RECONVERSION, DO NOT REMOVE
"a" = (
/turf/closed/indestructible/riveted/boss,
/area/lor/arena)
"b" = (
/turf/open/indestructible/honk{
	density = 1;
	desc = "this floors walls are made of gold, shining bright";
	name = "golden walls"
	},
/area/lor/arena)
"c" = (
/turf/open/floor/mineral/gold,
/area/lor/arena)
"d" = (
/turf/open/floor/carpet/red,
/area/lor/arena)
"e" = (
/obj/effect/landmark/library_reception_humans,
/turf/open/floor/carpet/red,
/area/lor/arena)
"f" = (
/obj/effect/landmark/library_reception_abno,
/turf/open/floor/carpet/red,
/area/lor/arena)
"g" = (
/turf/open/indestructible/hierophant{
	density = 1
	},
/area/lor/arena)
"h" = (
/turf/open/floor/bronze{
	density = 1;
	desc = "towering metal structures looming over the floor";
	name = "metal tower"
	},
/area/lor/arena)
"i" = (
/turf/open/lava/smooth{
	density = 1
	},
/area/lor/arena)
"j" = (
/turf/open/lava{
	density = 1
	},
/area/lor/arena)
"k" = (
/turf/open/indestructible/crystal_floor{
	density = 1;
	desc = "a golden fire pillar";
	name = "golden pillar"
	},
/area/lor/arena)

(1,1,1) = {"
a
a
a
a
a
a
a
a
a
a
a
a
a
a
a
a
a
a
a
a
a
"}
(2,1,1) = {"
a
b
b
b
b
b
c
c
c
d
d
d
d
d
c
c
c
g
g
g
a
"}
(3,1,1) = {"
a
b
b
b
b
b
c
c
c
d
d
d
d
d
c
c
c
g
g
g
a
"}
(4,1,1) = {"
a
b
b
b
b
b
c
c
c
d
d
d
d
d
c
c
c
g
g
g
a
"}
(5,1,1) = {"
a
b
b
b
b
b
c
c
c
e
d
d
d
e
c
c
c
g
g
g
a
"}
(6,1,1) = {"
a
b
b
b
b
b
c
c
c
d
d
d
d
d
c
c
c
h
g
g
a
"}
(7,1,1) = {"
a
b
b
b
b
b
c
c
c
d
d
e
d
d
c
c
c
h
g
g
a
"}
(8,1,1) = {"
a
b
b
b
b
b
c
c
c
d
d
d
d
d
c
c
c
h
h
g
a
"}
(9,1,1) = {"
a
b
b
b
b
b
c
c
c
e
d
d
d
e
c
c
c
h
h
g
a
"}
(10,1,1) = {"
a
b
b
b
b
b
c
c
c
d
d
d
d
d
c
c
c
h
h
h
a
"}
(11,1,1) = {"
a
b
j
k
k
k
c
c
c
d
d
d
d
d
c
c
c
h
h
h
a
"}
(12,1,1) = {"
a
b
j
k
k
k
c
c
c
d
d
d
d
d
c
c
c
h
h
h
a
"}
(13,1,1) = {"
a
b
b
b
b
b
c
c
c
d
d
d
d
d
c
c
c
h
h
h
a
"}
(14,1,1) = {"
a
b
b
b
b
b
c
c
c
d
d
d
d
d
c
c
c
h
h
i
a
"}
(15,1,1) = {"
a
b
b
b
b
b
c
c
c
f
d
d
d
f
c
c
c
h
h
i
a
"}
(16,1,1) = {"
a
b
b
b
b
b
c
c
c
d
d
d
d
d
c
c
c
h
i
i
a
"}
(17,1,1) = {"
a
b
b
b
b
b
c
c
c
d
d
f
d
d
c
c
c
h
i
i
a
"}
(18,1,1) = {"
a
b
b
b
b
b
c
c
c
d
d
d
d
d
c
c
c
i
i
i
a
"}
(19,1,1) = {"
a
b
b
b
b
b
c
c
c
f
d
d
d
f
c
c
c
i
i
i
a
"}
(20,1,1) = {"
a
b
b
b
b
b
c
c
c
d
d
d
d
d
c
c
c
i
i
i
a
"}
(21,1,1) = {"
a
b
b
b
b
b
c
c
c
d
d
d
d
d
c
c
c
i
i
i
a
"}
(22,1,1) = {"
a
b
b
b
b
b
c
c
c
d
d
d
d
d
c
c
c
i
i
i
a
"}
(23,1,1) = {"
a
a
a
a
a
a
a
a
a
a
a
a
a
a
a
a
a
a
a
a
a
"}
