//MAP CONVERTED BY dmm2tgm.py THIS HEADER COMMENT PREVENTS RECONVERSION, DO NOT REMOVE
"a" = (
/turf/closed/indestructible/riveted/boss,
/area/lor/arena)
"b" = (
/turf/open/floor/fakespace{
	density = 1;
	desc = "the stars shine over the city, changing its form";
	name = "city sky"
	},
/area/lor/arena)
"c" = (
/turf/open/floor/mineral/plastitanium,
/area/lor/arena)
"d" = (
/obj/effect/landmark/library_reception_humans,
/turf/open/floor/mineral/plastitanium,
/area/lor/arena)
"e" = (
/obj/effect/landmark/library_reception_abno,
/turf/open/floor/mineral/plastitanium,
/area/lor/arena)
"f" = (
/turf/open/floor/plating/sandy_dirt{
	density = 1;
	desc = "a cloudy mess is preventing people in the city from seeing the real sky";
	name = "hazy sky"
	},
/area/lor/arena)
"g" = (
/turf/open/floor/bronze{
	density = 1;
	desc = "towering metal structures looming over the floor";
	name = "metal tower"
	},
/area/lor/arena)
"h" = (
/obj/machinery/light/floor{
	name = "invincible floor light";
	resistance_flags = 64
	},
/turf/open/floor/mineral/plastitanium,
/area/lor/arena)
"i" = (
/obj/effect/landmark/library_reception_abno,
/obj/machinery/light/floor{
	name = "invincible floor light";
	resistance_flags = 64
	},
/turf/open/floor/mineral/plastitanium,
/area/lor/arena)
"j" = (
/obj/effect/landmark/library_reception_humans,
/obj/machinery/light/floor{
	name = "invincible floor light";
	resistance_flags = 64
	},
/turf/open/floor/mineral/plastitanium,
/area/lor/arena)
"k" = (
/turf/open/floor/white{
	density = 1;
	desc = "even if its not a star, it still shines brighter than them";
	name = "the moon"
	},
/area/lor/arena)

(1,1,1) = {"
a
a
a
a
a
a
a
a
a
a
a
a
a
a
a
a
a
a
a
a
a
"}
(2,1,1) = {"
a
b
b
b
b
b
c
c
c
c
c
c
c
c
c
c
c
f
f
g
a
"}
(3,1,1) = {"
a
b
b
b
b
b
c
h
c
h
c
h
c
h
c
h
c
f
f
g
a
"}
(4,1,1) = {"
a
b
b
b
b
b
c
c
c
c
c
c
c
c
c
c
c
f
f
g
a
"}
(5,1,1) = {"
a
b
b
b
b
b
h
c
h
d
h
c
h
d
h
c
h
f
f
g
a
"}
(6,1,1) = {"
a
b
b
b
b
b
c
c
c
c
c
c
c
c
c
c
c
f
f
g
a
"}
(7,1,1) = {"
a
b
b
b
b
b
c
h
c
h
c
j
c
h
c
h
c
f
f
g
a
"}
(8,1,1) = {"
a
b
b
b
b
b
c
c
c
c
c
c
c
c
c
c
c
f
f
g
a
"}
(9,1,1) = {"
a
b
b
b
b
b
h
c
h
d
h
c
h
d
h
c
h
f
f
g
a
"}
(10,1,1) = {"
a
b
b
b
b
b
c
c
c
c
c
c
c
c
c
c
c
f
f
g
a
"}
(11,1,1) = {"
a
k
k
b
b
b
c
h
c
h
c
h
c
h
c
h
c
f
f
g
a
"}
(12,1,1) = {"
a
k
k
b
b
b
c
c
c
c
c
c
c
c
c
c
c
f
f
g
a
"}
(13,1,1) = {"
a
k
k
b
b
b
h
c
h
c
h
c
h
c
h
c
h
f
f
g
a
"}
(14,1,1) = {"
a
b
b
b
b
b
c
c
c
c
c
c
c
c
c
c
c
f
f
g
a
"}
(15,1,1) = {"
a
b
b
b
b
b
c
h
c
i
c
h
c
i
c
h
c
f
f
g
a
"}
(16,1,1) = {"
a
b
b
b
b
b
c
c
c
c
c
c
c
c
c
c
c
f
f
g
a
"}
(17,1,1) = {"
a
b
b
b
b
b
h
c
h
c
h
e
h
c
h
c
h
f
f
g
a
"}
(18,1,1) = {"
a
b
b
b
b
b
c
c
c
c
c
c
c
c
c
c
c
f
f
g
a
"}
(19,1,1) = {"
a
b
b
b
b
b
c
h
c
i
c
h
c
i
c
h
c
f
f
g
a
"}
(20,1,1) = {"
a
b
b
b
b
b
c
c
c
c
c
c
c
c
c
c
c
f
f
g
a
"}
(21,1,1) = {"
a
b
b
b
b
b
h
c
h
c
h
c
h
c
h
c
h
f
f
g
a
"}
(22,1,1) = {"
a
b
b
b
b
b
c
c
c
c
c
c
c
c
c
c
c
f
f
g
a
"}
(23,1,1) = {"
a
a
a
a
a
a
a
a
a
a
a
a
a
a
a
a
a
a
a
a
a
"}
