//MAP CONVERTED BY dmm2tgm.py THIS HEADER COMMENT PREVENTS RECONVERSION, DO NOT REMOVE
"a" = (
/turf/closed/indestructible/riveted/boss,
/area/lor/arena)
"b" = (
/turf/open/floor/shelter,
/area/lor/arena)
"c" = (
/turf/open/floor/mineral/titanium/tiled/white,
/area/lor/arena)
"d" = (
/turf/open/floor/mineral/titanium/tiled,
/area/lor/arena)
"e" = (
/obj/effect/landmark/library_reception_humans,
/turf/open/floor/mineral/titanium/tiled,
/area/lor/arena)
"f" = (
/obj/effect/landmark/library_reception_abno,
/turf/open/floor/mineral/titanium/tiled,
/area/lor/arena)
"g" = (
/turf/open/floor/plating/ashplanet{
	density = 1;
	desc = "a grey pillar holding the bridge";
	name = "grey pillar"
	},
/area/lor/arena)
"h" = (
/turf/open/floor/holofloor/snow{
	density = 1;
	desc = "a giant ticking clock";
	name = "giant clock"
	},
/area/lor/arena)
"i" = (
/obj/item/toy/clockwork_watch,
/turf/open/floor/shelter,
/area/lor/arena)
"j" = (
/obj/structure/fluff/big_chain{
	desc = "a giant clock hand";
	name = "clock hand";
	resistance_flags = 64
	},
/turf/open/floor/holofloor/snow{
	density = 1;
	desc = "a giant ticking clock";
	name = "giant clock"
	},
/area/lor/arena)

(1,1,1) = {"
a
a
a
a
a
a
a
a
a
a
a
a
a
a
a
a
a
a
a
a
a
"}
(2,1,1) = {"
a
b
b
b
b
b
c
d
d
d
d
d
d
d
d
d
c
b
b
b
a
"}
(3,1,1) = {"
a
b
b
b
i
b
c
d
d
d
d
d
d
d
d
d
c
g
g
g
a
"}
(4,1,1) = {"
a
b
i
b
b
b
c
d
d
d
d
d
d
d
d
d
c
b
b
b
a
"}
(5,1,1) = {"
a
b
b
b
b
b
c
d
d
e
d
d
d
e
d
d
c
b
i
b
a
"}
(6,1,1) = {"
a
b
b
i
b
b
c
d
d
d
d
d
d
d
d
d
c
b
b
b
a
"}
(7,1,1) = {"
a
b
b
b
b
b
c
d
d
d
d
e
d
d
d
d
c
b
b
i
a
"}
(8,1,1) = {"
a
i
b
b
b
h
c
d
d
d
d
d
d
d
d
d
c
b
b
b
a
"}
(9,1,1) = {"
a
b
b
b
h
h
c
d
d
e
d
d
d
e
d
d
c
g
g
g
a
"}
(10,1,1) = {"
a
b
b
h
h
h
c
d
d
d
d
d
d
d
d
d
c
b
b
b
a
"}
(11,1,1) = {"
a
b
h
h
h
h
c
d
d
d
d
d
d
d
d
d
c
b
i
b
a
"}
(12,1,1) = {"
a
b
h
h
h
j
c
d
d
d
d
d
d
d
d
d
c
b
b
b
a
"}
(13,1,1) = {"
a
b
h
h
h
h
c
d
d
d
d
d
d
d
d
d
c
b
i
b
a
"}
(14,1,1) = {"
a
b
b
h
h
h
c
d
d
d
d
d
d
d
d
d
c
b
b
b
a
"}
(15,1,1) = {"
a
b
b
b
h
h
c
d
d
f
d
d
d
f
d
d
c
g
g
g
a
"}
(16,1,1) = {"
a
b
i
b
b
h
c
d
d
d
d
d
d
d
d
d
c
b
b
b
a
"}
(17,1,1) = {"
a
b
b
b
b
b
c
d
d
d
d
f
d
d
d
d
c
b
i
b
a
"}
(18,1,1) = {"
a
i
b
b
i
b
c
d
d
d
d
d
d
d
d
d
c
b
b
b
a
"}
(19,1,1) = {"
a
b
b
b
b
b
c
d
d
f
d
d
d
f
d
d
c
b
b
i
a
"}
(20,1,1) = {"
a
b
i
b
b
b
c
d
d
d
d
d
d
d
d
d
c
b
b
b
a
"}
(21,1,1) = {"
a
b
b
b
i
b
c
d
d
d
d
d
d
d
d
d
c
g
g
g
a
"}
(22,1,1) = {"
a
b
i
b
b
b
c
d
d
d
d
d
d
d
d
d
c
b
b
b
a
"}
(23,1,1) = {"
a
a
a
a
a
a
a
a
a
a
a
a
a
a
a
a
a
a
a
a
a
"}
