//MAP CONVERTED BY dmm2tgm.py THIS HEADER COMMENT PREVENTS RECONVERSION, DO NOT REMOVE
"a" = (
/obj/machinery/light/small{
	dir = 8
	},
/turf/open/floor/plating/dirt/jungle/dark,
/area/city/backstreets_room)
"c" = (
/obj/machinery/light/small{
	dir = 4
	},
/obj/effect/spawner/lootdrop/garbage_spawner,
/turf/open/floor/plating/dirt/jungle/dark,
/area/city/backstreets_room)
"e" = (
/obj/effect/decal/cleanable/blood/gibs/body,
/turf/open/floor/plating/dirt/jungle/dark,
/area/city/backstreets_room)
"f" = (
/obj/effect/spawner/lootdrop/garbage_spawner,
/turf/open/floor/plating/dirt/jungle/dark,
/area/city/backstreets_room)
"j" = (
/obj/machinery/light/small,
/turf/open/floor/plating/dirt/jungle/dark,
/area/city/backstreets_room)
"m" = (
/obj/effect/decal/cleanable/blood,
/obj/structure/closet/crate/trashcart,
/turf/open/floor/plating/dirt/jungle/dark,
/area/city/backstreets_room)
"r" = (
/turf/open/floor/plating/dirt/jungle/dark,
/area/city/backstreets_room)
"s" = (
/obj/effect/decal/cleanable/blood/splatter,
/obj/structure/closet/crate/trashcart,
/mob/living/simple_animal/mouse,
/turf/open/floor/plating/dirt/jungle/dark,
/area/city/backstreets_room)
"t" = (
/obj/effect/decal/cleanable/blood/gibs/up,
/turf/open/floor/plating/dirt/jungle/dark,
/area/city/backstreets_room)
"w" = (
/obj/effect/decal/cleanable/blood,
/turf/open/floor/plating/dirt/jungle/dark,
/area/city/backstreets_room)
"M" = (
/mob/living/simple_animal/hostile/ordeal/indigo_dawn,
/obj/effect/decal/cleanable/blood/footprints,
/turf/open/floor/plating/dirt/jungle/dark,
/area/city/backstreets_room)
"P" = (
/obj/effect/decal/cleanable/blood/drip,
/obj/effect/spawner/lootdrop/garbage_spawner,
/turf/open/floor/plating/dirt/jungle/dark,
/area/city/backstreets_room)
"R" = (
/obj/structure/closet/crate/trashcart/filled,
/turf/open/floor/plating/dirt/jungle/dark,
/area/city/backstreets_room)
"U" = (
/turf/closed/indestructible/reinforced,
/area/city/backstreets_room)
"Y" = (
/mob/living/simple_animal/hostile/ordeal/indigo_dawn,
/turf/open/floor/plating/dirt/jungle/dark,
/area/city/backstreets_room)

(1,1,1) = {"
U
U
U
U
U
"}
(2,1,1) = {"
P
a
f
m
U
"}
(3,1,1) = {"
r
M
e
R
U
"}
(4,1,1) = {"
f
r
j
U
U
"}
(5,1,1) = {"
r
t
Y
R
U
"}
(6,1,1) = {"
w
c
f
s
U
"}
(7,1,1) = {"
U
U
U
U
U
"}
