//MAP CONVERTED BY dmm2tgm.py THIS HEADER COMMENT PREVENTS RECONVERSION, DO NOT REMOVE
"a" = (
/turf/open/floor/plating/asteroid/basalt,
/area/city/backstreets_room)
"t" = (
/obj/effect/spawner/lootdrop/garbage_spawner,
/turf/open/floor/plating/asteroid/basalt,
/area/city/backstreets_room)
"x" = (
/mob/living/simple_animal/hostile/humanoid/rat/hammer,
/turf/open/floor/plating/asteroid/basalt,
/area/city/backstreets_room)
"C" = (
/obj/item/ego_weapon/city/rats/brick,
/turf/open/floor/plating/asteroid/basalt,
/area/city/backstreets_room)
"M" = (
/mob/living/simple_animal/hostile/humanoid/rat/zippy,
/turf/open/floor/plating/asteroid/basalt,
/area/city/backstreets_room)
"P" = (
/obj/effect/decal/cleanable/garbage,
/turf/open/floor/plating/asteroid/basalt,
/area/city/backstreets_room)
"R" = (
/obj/structure/closet/crate/trashcart/filled,
/turf/open/floor/plating/asteroid/basalt,
/area/city/backstreets_room)
"U" = (
/turf/closed/indestructible/reinforced,
/area/city/backstreets_room)

(1,1,1) = {"
U
U
U
U
U
"}
(2,1,1) = {"
t
a
t
R
U
"}
(3,1,1) = {"
P
M
P
R
U
"}
(4,1,1) = {"
a
a
a
C
U
"}
(5,1,1) = {"
a
t
a
R
U
"}
(6,1,1) = {"
t
x
P
R
U
"}
(7,1,1) = {"
U
U
U
U
U
"}
