//MAP CONVERTED BY dmm2tgm.py THIS HEADER COMMENT PREVENTS RECONVERSION, DO NOT REMOVE
"a" = (
/obj/effect/landmark/cratespawn,
/turf/open/floor/plasteel/elevatorshaft{
	name = "Metallic Flooring"
	},
/area/city/backstreets_room)
"t" = (
/turf/open/floor/plasteel/elevatorshaft{
	name = "Metallic Flooring"
	},
/area/city/backstreets_room)
"x" = (
/mob/living/simple_animal/hostile/ordeal/green_bot_big{
	name = "gunbot"
	},
/turf/open/floor/plasteel/elevatorshaft{
	name = "Metallic Flooring"
	},
/area/city/backstreets_room)
"M" = (
/obj/structure/lootcrate/money,
/turf/open/floor/plasteel/elevatorshaft{
	name = "Metallic Flooring"
	},
/area/city/backstreets_room)
"P" = (
/obj/machinery/door/airlock/centcom,
/turf/open/floor/plasteel/elevatorshaft{
	name = "Metallic Flooring"
	},
/area/city/backstreets_room)
"R" = (
/mob/living/simple_animal/hostile/ordeal/green_bot,
/turf/open/floor/plasteel/elevatorshaft{
	name = "Metallic Flooring"
	},
/area/city/backstreets_room)
"U" = (
/turf/closed/indestructible/reinforced,
/area/city/backstreets_room)

(1,1,1) = {"
U
U
U
U
U
"}
(2,1,1) = {"
U
R
a
a
U
"}
(3,1,1) = {"
U
t
t
x
U
"}
(4,1,1) = {"
P
t
t
t
U
"}
(5,1,1) = {"
U
t
t
x
U
"}
(6,1,1) = {"
U
R
M
M
U
"}
(7,1,1) = {"
U
U
U
U
U
"}
