//MAP CONVERTED BY dmm2tgm.py THIS HEADER COMMENT PREVENTS RECONVERSION, DO NOT REMOVE
"gl" = (
/turf/closed/indestructible/reinforced,
/area/city/backstreets_room)
"gJ" = (
/obj/effect/turf_decal/siding/wood{
	color = "#2e1f0e"
	},
/turf/open/floor/plating/beach/sand,
/area/city/backstreets_room)
"hY" = (
/obj/structure/chair/pew/left{
	dir = 4
	},
/turf/open/floor/wood,
/area/city/backstreets_room)
"iN" = (
/obj/effect/turf_decal/siding/wood{
	color = "#694720";
	dir = 1
	},
/turf/open/floor/plating/beach/sand,
/area/city/backstreets_room)
"mX" = (
/turf/open/floor/wood,
/area/city/backstreets_room)
"nG" = (
/obj/effect/turf_decal/siding/wood{
	color = "#2e1f0e";
	dir = 5
	},
/obj/structure/flora/ausbushes/lavendergrass{
	pixel_x = -6
	},
/obj/effect/decal/cleanable/dirt,
/turf/open/floor/plating/beach/sand,
/area/city/backstreets_room)
"ql" = (
/obj/structure/chair/pew/left{
	dir = 8
	},
/obj/effect/decal/cleanable/dirt,
/turf/open/floor/wood,
/area/city/backstreets_room)
"rJ" = (
/obj/effect/decal/cleanable/blood/gibs/body,
/turf/open/floor/plating/beach/sand,
/area/city/backstreets_room)
"tk" = (
/obj/structure/table/wood,
/obj/item/food/sashimi,
/obj/item/reagent_containers/food/drinks/coffee{
	pixel_x = 7;
	pixel_y = 8
	},
/turf/open/floor/wood,
/area/city/backstreets_room)
"tH" = (
/obj/structure/window/paperframe,
/obj/effect/decal/cleanable/dirt,
/turf/open/floor/wood,
/area/city/backstreets_room)
"uK" = (
/obj/effect/turf_decal/siding/wood{
	color = "#2e1f0e";
	dir = 10
	},
/turf/open/floor/plating/beach/sand,
/area/city/backstreets_room)
"vm" = (
/obj/effect/turf_decal/siding/wood{
	color = "#2e1f0e";
	dir = 9
	},
/obj/structure/flora/ausbushes/lavendergrass,
/turf/open/floor/plating/beach/sand,
/area/city/backstreets_room)
"zI" = (
/obj/structure/lootcrate/syndicate,
/obj/effect/decal/cleanable/dirt,
/turf/open/floor/wood,
/area/city/backstreets_room)
"BV" = (
/obj/effect/turf_decal/siding/wood,
/obj/effect/light_emitter{
	light_power = 4;
	light_range = 25;
	set_cap = 3;
	set_luminosity = 24
	},
/turf/open/floor/plating/beach/sand,
/area/city/backstreets_room)
"Cw" = (
/turf/open/floor/plating/beach/sand,
/area/city/backstreets_room)
"Da" = (
/obj/structure/chair/pew/right{
	dir = 4
	},
/obj/effect/decal/cleanable/dirt,
/turf/open/floor/wood,
/area/city/backstreets_room)
"Dl" = (
/obj/effect/turf_decal/siding/wood{
	color = "#2e1f0e";
	dir = 1
	},
/obj/effect/gibspawner/generic/silent,
/turf/open/floor/plating/beach/sand,
/area/city/backstreets_room)
"Gp" = (
/obj/effect/decal/cleanable/dirt,
/obj/structure/lootcrate/money,
/turf/open/floor/wood,
/area/city/backstreets_room)
"HL" = (
/obj/structure/lootcrate/syndicate,
/turf/open/floor/wood,
/area/city/backstreets_room)
"IF" = (
/mob/living/simple_animal/hostile/humanoid/rat/knife,
/turf/open/floor/plating/beach/sand,
/area/city/backstreets_room)
"IT" = (
/obj/effect/turf_decal/siding/wood{
	dir = 4
	},
/turf/open/floor/plating/beach/sand,
/area/city/backstreets_room)
"Jj" = (
/obj/structure/mineral_door/paperframe,
/obj/effect/decal/cleanable/dirt,
/turf/open/floor/wood,
/area/city/backstreets_room)
"Jl" = (
/obj/structure/flora/ausbushes/lavendergrass{
	pixel_y = 6
	},
/obj/effect/turf_decal/siding/wood{
	color = "#2e1f0e"
	},
/mob/living/simple_animal/hostile/humanoid/rat,
/turf/open/floor/plating/beach/sand,
/area/city/backstreets_room)
"KE" = (
/obj/effect/turf_decal/siding/wood{
	color = "#2e1f0e";
	dir = 6
	},
/obj/structure/flora/ausbushes/lavendergrass{
	pixel_x = -5;
	pixel_y = 5
	},
/obj/effect/gibspawner/generic/silent,
/turf/open/floor/plating/beach/sand,
/area/city/backstreets_room)
"Lf" = (
/obj/effect/turf_decal/siding/wood{
	color = "#694720";
	dir = 1
	},
/mob/living/simple_animal/hostile/humanoid/rat/pipe,
/turf/open/floor/plating/beach/sand,
/area/city/backstreets_room)
"On" = (
/obj/structure/mineral_door/paperframe,
/turf/open/floor/wood,
/area/city/backstreets_room)
"Pg" = (
/obj/effect/turf_decal/siding/wood{
	color = "#2e1f0e";
	dir = 8
	},
/obj/effect/decal/cleanable/blood/gibs/down,
/turf/open/floor/plating/beach/sand,
/area/city/backstreets_room)
"PO" = (
/obj/effect/turf_decal/siding/wood{
	color = "#2e1f0e";
	dir = 1
	},
/mob/living/simple_animal/hostile/humanoid/rat,
/turf/open/floor/plating/beach/sand,
/area/city/backstreets_room)
"Qu" = (
/obj/structure/window/paperframe,
/turf/open/floor/wood,
/area/city/backstreets_room)
"QS" = (
/obj/structure/table/wood,
/obj/item/food/sashimi,
/obj/item/reagent_containers/food/drinks/coffee{
	pixel_x = 7;
	pixel_y = 7
	},
/obj/effect/decal/cleanable/dirt,
/turf/open/floor/wood,
/area/city/backstreets_room)
"Ry" = (
/obj/effect/turf_decal/siding/wood{
	dir = 8
	},
/obj/effect/gibspawner/generic/silent,
/turf/open/floor/plating/beach/sand,
/area/city/backstreets_room)
"RL" = (
/obj/effect/turf_decal/siding/wood,
/mob/living/simple_animal/hostile/humanoid/rat/pipe,
/turf/open/floor/plating/beach/sand,
/area/city/backstreets_room)
"Th" = (
/mob/living/simple_animal/hostile/humanoid/rat/zippy,
/obj/effect/decal/cleanable/dirt,
/turf/open/floor/wood,
/area/city/backstreets_room)
"Ti" = (
/turf/closed/indestructible/wood,
/area/city/backstreets_room)
"Ts" = (
/mob/living/simple_animal/hostile/humanoid/rat/hammer,
/turf/open/floor/plating/beach/sand,
/area/city/backstreets_room)
"Wt" = (
/obj/effect/decal/cleanable/dirt,
/turf/open/floor/wood,
/area/city/backstreets_room)
"Xb" = (
/obj/structure/table/wood,
/obj/effect/decal/cleanable/dirt,
/turf/open/floor/wood,
/area/city/backstreets_room)
"XH" = (
/obj/effect/turf_decal/siding/wood{
	color = "#2e1f0e";
	dir = 4
	},
/obj/effect/decal/cleanable/blood/gibs/up,
/turf/open/floor/plating/beach/sand,
/area/city/backstreets_room)
"XV" = (
/obj/structure/flora/ausbushes/lavendergrass,
/mob/living/simple_animal/hostile/humanoid/rat,
/turf/open/floor/plating/beach/sand,
/area/city/backstreets_room)
"XY" = (
/obj/structure/chair/pew/right{
	dir = 8
	},
/turf/open/floor/wood,
/area/city/backstreets_room)
"Yn" = (
/obj/structure/flora/ausbushes/lavendergrass,
/mob/living/simple_animal/hostile/humanoid/rat/hammer,
/turf/open/floor/plating/beach/sand,
/area/city/backstreets_room)

(1,1,1) = {"
Ti
Ti
Ti
Ti
Ti
Ti
Ti
gl
"}
(2,1,1) = {"
Ti
tk
Wt
Wt
Wt
Wt
mX
On
"}
(3,1,1) = {"
Ti
Xb
Wt
Da
hY
Wt
Wt
On
"}
(4,1,1) = {"
Ti
Qu
Jj
tH
tH
Jj
tH
gl
"}
(5,1,1) = {"
Ti
HL
Wt
mX
Wt
Wt
Th
gl
"}
(6,1,1) = {"
Ti
Wt
vm
Ry
Pg
uK
HL
gl
"}
(7,1,1) = {"
Ti
Gp
PO
IF
Cw
Jl
Wt
gl
"}
(8,1,1) = {"
Ti
zI
iN
Cw
XV
RL
Wt
gl
"}
(9,1,1) = {"
Ti
Wt
Lf
Yn
Cw
BV
Wt
gl
"}
(10,1,1) = {"
Ti
mX
Dl
rJ
Ts
gJ
HL
gl
"}
(11,1,1) = {"
Ti
Wt
nG
IT
XH
KE
Wt
gl
"}
(12,1,1) = {"
Ti
zI
Wt
Wt
mX
Wt
Th
gl
"}
(13,1,1) = {"
Ti
tH
Jj
tH
Qu
Jj
tH
gl
"}
(14,1,1) = {"
Ti
QS
Wt
ql
XY
Wt
Wt
On
"}
(15,1,1) = {"
Ti
Xb
Wt
mX
mX
mX
mX
On
"}
(16,1,1) = {"
Ti
Ti
Ti
Ti
Ti
Ti
Ti
gl
"}
