//MAP CONVERTED BY dmm2tgm.py THIS HEADER COMMENT PREVENTS RECONVERSION, DO NOT REMOVE
"a" = (
/turf/open/indestructible/white,
/area/city/backstreets_room)
"g" = (
/obj/structure/closet/crate/secure/science,
/obj/item/clothing/under/rank/rnd/scientist/skirt,
/obj/item/clothing/under/rank/rnd/scientist,
/obj/item/clothing/head/helmet/space/plasmaman/science,
/obj/item/clothing/glasses/science,
/obj/item/storage/backpack/science,
/obj/item/clothing/under/plasmaman/science,
/turf/open/indestructible/white,
/area/city/backstreets_room)
"j" = (
/mob/living/simple_animal/hostile/morph,
/turf/open/indestructible/white,
/area/city/backstreets_room)
"k" = (
/turf/closed/indestructible/fakeglass,
/area/city/backstreets_room)
"m" = (
/mob/living/simple_animal/hostile/asteroid/goliath/beast{
	faction = list("neutral")
	},
/turf/open/indestructible/white,
/area/city/backstreets_room)
"n" = (
/obj/machinery/door/airlock/survival_pod/glass,
/turf/open/indestructible/white,
/area/city/backstreets_room)
"s" = (
/obj/machinery/door/airlock/freezer,
/turf/open/indestructible/white,
/area/city/backstreets_alley)
"w" = (
/obj/machinery/door/airlock/freezer,
/turf/open/indestructible/white,
/area/city/backstreets_room)
"x" = (
/obj/structure/safe,
/obj/item/folder/syndicate/blue,
/obj/item/folder/syndicate/blue,
/obj/item/folder/syndicate/red,
/obj/item/folder/blue,
/obj/item/folder/blue,
/turf/open/indestructible/white,
/area/city/backstreets_room)
"y" = (
/obj/machinery/modular_computer/console/preset/research,
/turf/open/indestructible/white,
/area/city/backstreets_room)
"E" = (
/obj/machinery/light/warm,
/turf/open/indestructible/white,
/area/city/backstreets_room)
"H" = (
/turf/closed/indestructible/riveted/plastinum,
/area/city/backstreets_room)
"L" = (
/obj/machinery/light/dim,
/turf/closed/indestructible/riveted/plastinum,
/area/city/backstreets_room)
"O" = (
/obj/structure/closet/secure_closet/armory1{
	dir = 4
	},
/obj/item/ego_weapon/city/kcorp/spear,
/obj/item/gun/ego_gun/pistol/kcorp/smg,
/obj/item/clothing/under/rank/k_corporation/officer,
/obj/item/clothing/under/rank/k_corporation/officer,
/turf/open/indestructible/white,
/area/city/backstreets_room)
"S" = (
/mob/living/simple_animal/hostile/blob/blobspore/weak{
	faction = list("neutral")
	},
/turf/open/indestructible/white,
/area/city/backstreets_room)
"U" = (
/obj/machinery/atmospherics/components/unary/cryo_cell{
	plane = 0
	},
/mob/living/carbon/human{
	anchored = 1;
	pixel_y = 24
	},
/turf/open/indestructible/white,
/area/city/backstreets_room)
"W" = (
/mob/living/simple_animal/hostile/carp/megacarp{
	faction = list("neutral")
	},
/turf/open/indestructible/white,
/area/city/backstreets_room)
"Y" = (
/obj/effect/spawner/structure/window/shuttle,
/turf/open/indestructible/white,
/area/city/backstreets_room)
"Z" = (
/obj/machinery/light/red,
/turf/closed/indestructible/riveted/plastinum,
/area/city/backstreets_room)

(1,1,1) = {"
H
H
H
H
H
H
H
H
"}
(2,1,1) = {"
H
m
a
k
a
a
g
H
"}
(3,1,1) = {"
Z
a
m
k
a
y
E
H
"}
(4,1,1) = {"
H
m
a
k
a
a
a
Y
"}
(5,1,1) = {"
H
k
k
k
U
a
a
Y
"}
(6,1,1) = {"
Z
W
a
k
a
a
a
Y
"}
(7,1,1) = {"
H
a
a
k
a
a
a
H
"}
(8,1,1) = {"
H
k
k
k
x
a
a
w
"}
(9,1,1) = {"
Z
S
a
k
a
a
a
s
"}
(10,1,1) = {"
H
S
a
k
a
a
a
H
"}
(11,1,1) = {"
H
k
k
k
U
a
a
Y
"}
(12,1,1) = {"
Z
a
j
k
a
a
a
Y
"}
(13,1,1) = {"
H
a
a
k
a
a
a
Y
"}
(14,1,1) = {"
H
k
k
k
a
y
E
H
"}
(15,1,1) = {"
L
O
a
n
a
a
a
H
"}
(16,1,1) = {"
H
H
H
H
H
H
H
H
"}
