//MAP CONVERTED BY dmm2tgm.py THIS HEADER COMMENT PREVENTS RECONVERSION, DO NOT REMOVE
"a" = (
/obj/machinery/light/small{
	dir = 8
	},
/turf/open/floor/plating/dirt/jungle/dark,
/area/city/backstreets_room)
"b" = (
/obj/machinery/door/airlock/gold,
/turf/open/floor/plating/dirt/jungle/dark,
/area/city/backstreets_room)
"c" = (
/obj/structure/cursed_money,
/obj/effect/light_emitter{
	light_power = 4;
	light_range = 25;
	set_cap = 3;
	set_luminosity = 24
	},
/turf/open/floor/mineral/gold,
/area/city/backstreets_room)
"e" = (
/obj/item/storage/bag/money,
/obj/item/storage/bag/money,
/turf/open/floor/carpet/orange,
/area/city/backstreets_room)
"f" = (
/obj/structure/table/greyscale,
/turf/open/floor/plasteel/shuttle{
	name = "floor"
	},
/area/city/backstreets_room)
"h" = (
/obj/effect/turf_decal/weather/dirt{
	dir = 9
	},
/obj/effect/spawner/lootdrop/space/cashmoney,
/obj/effect/spawner/lootdrop/space/cashmoney,
/obj/effect/spawner/lootdrop/space/cashmoney,
/obj/effect/spawner/lootdrop/space/cashmoney,
/obj/effect/spawner/lootdrop/space/cashmoney,
/turf/open/floor/grass,
/area/city/backstreets_room)
"i" = (
/obj/effect/turf_decal/weather/dirt{
	dir = 3
	},
/obj/effect/spawner/lootdrop/space/cashmoney,
/obj/effect/spawner/lootdrop/space/cashmoney,
/obj/effect/spawner/lootdrop/space/cashmoney,
/turf/open/floor/grass,
/area/city/backstreets_room)
"j" = (
/obj/effect/turf_decal/weather/dirt{
	dir = 4
	},
/obj/effect/spawner/lootdrop/space/cashmoney,
/obj/effect/spawner/lootdrop/space/cashmoney,
/obj/effect/spawner/lootdrop/space/cashmoney,
/obj/effect/spawner/lootdrop/space/cashmoney,
/turf/open/floor/grass,
/area/city/backstreets_room)
"k" = (
/obj/effect/turf_decal/weather/dirt{
	dir = 6
	},
/obj/effect/spawner/lootdrop/space/cashmoney,
/obj/effect/spawner/lootdrop/space/cashmoney,
/obj/effect/spawner/lootdrop/space/cashmoney,
/obj/effect/spawner/lootdrop/space/cashmoney,
/turf/open/floor/grass,
/area/city/backstreets_room)
"l" = (
/obj/item/food/grown/apple/gold/abnormality,
/turf/open/floor/carpet/orange,
/area/city/backstreets_room)
"m" = (
/obj/structure/mineral_door/wood,
/turf/open/floor/plasteel/shuttle{
	name = "floor"
	},
/area/city/backstreets_room)
"n" = (
/turf/closed/indestructible/rock,
/area/city/backstreets_room)
"p" = (
/obj/effect/turf_decal/weather/dirt{
	dir = 1
	},
/obj/effect/spawner/lootdrop/space/cashmoney,
/obj/effect/spawner/lootdrop/space/cashmoney,
/obj/effect/spawner/lootdrop/space/cashmoney,
/turf/open/floor/grass,
/area/city/backstreets_room)
"q" = (
/obj/machinery/light/dim{
	dir = 4
	},
/turf/open/floor/plasteel/shuttle{
	name = "floor"
	},
/area/city/backstreets_room)
"r" = (
/obj/machinery/door/airlock/centcom{
	desc = "A bit too sturdy...";
	max_integrity = 10000;
	name = "Strange Airlock";
	normal_integrity = 100000;
	req_access_txt = "19"
	},
/turf/open/floor/plasteel/shuttle{
	name = "floor"
	},
/area/city/backstreets_room)
"s" = (
/obj/item/instrument/violin/golden,
/turf/open/floor/carpet/orange,
/area/city/backstreets_room)
"u" = (
/obj/item/stack/sheet/mineral/gold,
/turf/open/floor/carpet/orange,
/area/city/backstreets_room)
"v" = (
/turf/open/floor/plasteel/shuttle{
	name = "floor"
	},
/area/city/backstreets_room)
"x" = (
/obj/item/slime_cookie/gold,
/turf/open/floor/carpet/orange,
/area/city/backstreets_room)
"y" = (
/turf/open/floor/mineral/gold,
/area/city/backstreets_room)
"A" = (
/obj/effect/turf_decal/weather/dirt{
	dir = 8
	},
/obj/effect/spawner/lootdrop/space/cashmoney,
/obj/effect/spawner/lootdrop/space/cashmoney,
/turf/open/floor/grass,
/area/city/backstreets_room)
"E" = (
/turf/open/floor/grass,
/area/city/backstreets_room)
"H" = (
/obj/item/seeds/apple/gold,
/turf/open/floor/carpet/orange,
/area/city/backstreets_room)
"I" = (
/obj/effect/turf_decal/weather/dirt{
	dir = 10
	},
/obj/effect/spawner/lootdrop/space/cashmoney,
/obj/effect/spawner/lootdrop/space/cashmoney,
/obj/effect/spawner/lootdrop/space/cashmoney,
/turf/open/floor/grass,
/area/city/backstreets_room)
"L" = (
/turf/closed/indestructible/reinforced,
/area/city/backstreets_room)
"M" = (
/obj/machinery/light/dim{
	dir = 8;
	pixel_x = null;
	pixel_y = null
	},
/turf/open/floor/plasteel/shuttle{
	name = "floor"
	},
/area/city/backstreets_room)
"N" = (
/obj/item/gun/ballistic/automatic/pistol/deagle/gold,
/turf/open/floor/carpet/orange,
/area/city/backstreets_room)
"O" = (
/turf/open/floor/plating/dirt/jungle/dark,
/area/city/backstreets_room)
"T" = (
/obj/structure/flora/tree/jungle{
	pixel_x = -30
	},
/turf/open/floor/grass,
/area/city/backstreets_room)
"U" = (
/obj/item/gun/ballistic/revolver/golden,
/turf/open/floor/carpet/orange,
/area/city/backstreets_room)
"V" = (
/obj/item/coin/gold/debug,
/obj/effect/light_emitter{
	light_power = 4;
	light_range = 25;
	set_cap = 3;
	set_luminosity = 24
	},
/turf/open/floor/carpet/lone,
/area/city/backstreets_room)
"W" = (
/obj/effect/turf_decal/weather/dirt{
	dir = 5
	},
/obj/effect/spawner/lootdrop/space/cashmoney,
/obj/effect/spawner/lootdrop/space/cashmoney,
/obj/effect/spawner/lootdrop/space/cashmoney,
/obj/effect/spawner/lootdrop/space/cashmoney,
/turf/open/floor/grass,
/area/city/backstreets_room)
"Z" = (
/obj/item/storage/bag/money,
/turf/open/floor/carpet/orange,
/area/city/backstreets_room)

(1,1,1) = {"
n
n
n
L
L
L
L
L
"}
(2,1,1) = {"
n
L
L
L
v
M
v
L
"}
(3,1,1) = {"
n
L
a
r
v
f
v
m
"}
(4,1,1) = {"
n
L
O
L
v
q
v
L
"}
(5,1,1) = {"
n
L
b
L
L
L
L
L
"}
(6,1,1) = {"
n
L
y
N
s
x
y
L
"}
(7,1,1) = {"
n
L
y
U
V
l
y
L
"}
(8,1,1) = {"
n
L
y
u
u
H
y
L
"}
(9,1,1) = {"
n
L
y
h
A
I
y
L
"}
(10,1,1) = {"
n
L
y
p
T
i
y
L
"}
(11,1,1) = {"
n
L
y
p
E
i
y
L
"}
(12,1,1) = {"
n
L
y
W
j
k
y
L
"}
(13,1,1) = {"
n
L
y
Z
Z
e
y
L
"}
(14,1,1) = {"
n
L
y
Z
c
Z
y
L
"}
(15,1,1) = {"
n
L
y
Z
Z
Z
y
L
"}
(16,1,1) = {"
n
L
L
L
L
L
L
L
"}
