//MAP CONVERTED BY dmm2tgm.py THIS HEADER COMMENT PREVENTS RECONVERSION, DO NOT REMOVE
"a" = (
/obj/effect/turf_decal/siding/purple{
	dir = 1
	},
/obj/structure/table/wood/fancy/purple,
/obj/item/reagent_containers/food/drinks/soda_cans/wellcheers_purple{
	pixel_x = 5
	},
/obj/item/reagent_containers/food/drinks/soda_cans/wellcheers_purple{
	pixel_x = -5
	},
/obj/item/reagent_containers/food/drinks/soda_cans/wellcheers_purple,
/turf/open/floor/carpet/purple,
/area/city/backstreets_room)
"b" = (
/obj/effect/turf_decal/siding/purple{
	dir = 1
	},
/obj/structure/table/wood/fancy/purple,
/obj/item/reagent_containers/food/drinks/soda_cans/wellcheers_purple{
	pixel_x = 5
	},
/obj/item/reagent_containers/food/drinks/soda_cans/wellcheers_purple{
	pixel_x = -5
	},
/obj/item/reagent_containers/food/drinks/soda_cans/wellcheers_purple,
/obj/machinery/light{
	dir = 1
	},
/turf/open/floor/carpet/purple,
/area/city/backstreets_room)
"c" = (
/obj/effect/turf_decal/siding/purple{
	dir = 1
	},
/obj/structure/table/wood/fancy/purple,
/obj/item/reagent_containers/food/drinks/colocup/lean,
/turf/open/floor/carpet/purple,
/area/city/backstreets_room)
"d" = (
/obj/effect/turf_decal/siding/purple{
	dir = 5
	},
/obj/structure/filingcabinet{
	pixel_x = 10
	},
/obj/structure/filingcabinet,
/obj/structure/filingcabinet{
	pixel_x = -9
	},
/turf/open/floor/carpet/purple,
/area/city/backstreets_room)
"e" = (
/obj/structure/table/glass,
/obj/item/gun/ego_gun/sodasmg,
/turf/open/floor/plasteel/vaporwave,
/area/city/backstreets_room)
"f" = (
/obj/effect/turf_decal/siding/purple{
	dir = 10
	},
/turf/open/floor/carpet/purple,
/area/city/backstreets_room)
"g" = (
/obj/structure/table/wood/fancy/purple,
/turf/open/floor/carpet/purple,
/area/city/backstreets_room)
"h" = (
/obj/machinery/light,
/turf/open/floor/wood,
/area/city/backstreets_room)
"l" = (
/obj/effect/turf_decal/siding/purple{
	dir = 7
	},
/obj/structure/table/wood/fancy/purple,
/turf/open/floor/carpet/purple,
/area/city/backstreets_room)
"m" = (
/turf/open/floor/carpet/purple,
/area/city/backstreets_room)
"n" = (
/obj/machinery/door/airlock/silver/glass,
/turf/open/floor/plasteel/shuttle{
	name = "floor"
	},
/area/city/backstreets_room)
"o" = (
/turf/open/floor/plasteel/rockvault/alien{
	name = "floor"
	},
/area/city/backstreets_room)
"p" = (
/obj/machinery/light{
	dir = 4
	},
/obj/structure/window/reinforced/survival_pod{
	desc = "Shrimply too strong.";
	dir = 1;
	max_integrity = 10000;
	name = "shrimp display window"
	},
/obj/structure/lootcrate/s_corp,
/turf/open/floor/plasteel/vaporwave,
/area/city/backstreets_room)
"q" = (
/obj/effect/turf_decal/siding/purple{
	dir = 8
	},
/obj/structure/chair/sofa/right{
	dir = 4
	},
/turf/open/floor/carpet/purple,
/area/city/backstreets_room)
"t" = (
/obj/effect/turf_decal/siding/purple{
	dir = 4
	},
/mob/living/simple_animal/hostile/shrimp,
/obj/structure/chair/comfy/lime{
	dir = 8
	},
/turf/open/floor/carpet/purple,
/area/city/backstreets_room)
"u" = (
/mob/living/simple_animal/hostile/shrimp_soldier,
/turf/open/floor/wood,
/area/city/backstreets_room)
"w" = (
/obj/effect/turf_decal/siding/purple{
	dir = 6
	},
/obj/structure/filingcabinet{
	pixel_x = 10
	},
/obj/structure/filingcabinet,
/obj/structure/filingcabinet{
	pixel_x = -9
	},
/turf/open/floor/carpet/purple,
/area/city/backstreets_room)
"x" = (
/obj/effect/turf_decal/siding/purple{
	dir = 4
	},
/turf/open/floor/carpet/purple,
/area/city/backstreets_room)
"y" = (
/mob/living/simple_animal/hostile/shrimp_soldier,
/turf/open/floor/plasteel/vaporwave,
/area/city/backstreets_room)
"z" = (
/obj/effect/turf_decal/siding/purple{
	dir = 8
	},
/obj/structure/chair/plastic{
	dir = 4
	},
/turf/open/floor/carpet/purple,
/area/city/backstreets_room)
"A" = (
/obj/structure/table/glass,
/obj/item/gun/ego_gun/shrimp/assault,
/turf/open/floor/plasteel/vaporwave,
/area/city/backstreets_room)
"C" = (
/obj/machinery/door/airlock/silver/glass,
/turf/open/floor/plasteel/rockvault/alien{
	name = "floor"
	},
/area/city/backstreets_room)
"E" = (
/obj/machinery/light{
	dir = 4
	},
/obj/structure/window/reinforced/survival_pod{
	desc = "Shrimply too strong.";
	max_integrity = 10000;
	name = "shrimp display window"
	},
/obj/structure/lootcrate/s_corp,
/turf/open/floor/plasteel/vaporwave,
/area/city/backstreets_room)
"F" = (
/obj/structure/table/glass,
/obj/item/trait_injector/shrimp_injector,
/turf/open/floor/plasteel/vaporwave,
/area/city/backstreets_room)
"G" = (
/obj/structure/lootcrate/s_corp,
/turf/open/floor/plasteel/vaporwave,
/area/city/backstreets_room)
"H" = (
/obj/effect/turf_decal/siding/purple{
	dir = 9
	},
/turf/open/floor/carpet/purple,
/area/city/backstreets_room)
"I" = (
/obj/effect/turf_decal/siding/purple{
	dir = 7
	},
/turf/open/floor/carpet/purple,
/area/city/backstreets_room)
"J" = (
/obj/structure/table/glass,
/obj/item/trait_injector/shrimp_injector,
/obj/item/grenade/spawnergrenade/shrimp/super{
	pixel_y = -15
	},
/turf/open/floor/plasteel/vaporwave,
/area/city/backstreets_room)
"K" = (
/obj/machinery/light{
	dir = 1
	},
/turf/open/floor/wood,
/area/city/backstreets_room)
"L" = (
/turf/closed/indestructible/reinforced,
/area/city/backstreets_room)
"M" = (
/obj/machinery/door/airlock/silver/glass,
/turf/open/floor/wood,
/area/city/backstreets_room)
"N" = (
/obj/structure/table/glass,
/obj/item/gun/ego_gun/pistol/soda,
/turf/open/floor/plasteel/vaporwave,
/area/city/backstreets_room)
"O" = (
/obj/structure/table/glass,
/obj/item/kirbyplants/random{
	pixel_y = 10
	},
/turf/open/floor/wood,
/area/city/backstreets_room)
"P" = (
/obj/effect/turf_decal/siding/purple{
	dir = 6
	},
/obj/structure/table/glass,
/obj/item/kirbyplants/random{
	pixel_y = 10
	},
/turf/open/floor/carpet/purple,
/area/city/backstreets_room)
"Q" = (
/obj/structure/window/reinforced/survival_pod{
	desc = "Shrimply too strong.";
	dir = 4;
	max_integrity = 10000;
	name = "shrimp display window"
	},
/turf/open/floor/plasteel/rockvault/alien{
	name = "floor"
	},
/area/city/backstreets_room)
"R" = (
/obj/structure/table/glass,
/obj/item/gun/ego_gun/sodarifle,
/turf/open/floor/plasteel/vaporwave,
/area/city/backstreets_room)
"T" = (
/turf/open/floor/wood,
/area/city/backstreets_room)
"U" = (
/turf/open/floor/plasteel/vaporwave,
/area/city/backstreets_room)
"V" = (
/obj/machinery/light{
	dir = 4
	},
/turf/open/floor/wood,
/area/city/backstreets_room)
"W" = (
/obj/effect/turf_decal/siding/purple{
	dir = 8
	},
/obj/structure/chair/sofa{
	dir = 4
	},
/turf/open/floor/carpet/purple,
/area/city/backstreets_room)
"X" = (
/obj/effect/turf_decal/siding/purple{
	dir = 8
	},
/obj/structure/chair/sofa/left{
	dir = 4
	},
/turf/open/floor/carpet/purple,
/area/city/backstreets_room)
"Z" = (
/obj/effect/turf_decal/siding/purple{
	dir = 10
	},
/obj/structure/table/glass,
/obj/item/kirbyplants/random{
	pixel_y = 10
	},
/turf/open/floor/carpet/purple,
/area/city/backstreets_room)

(1,1,1) = {"
L
L
L
L
L
L
L
L
"}
(2,1,1) = {"
L
a
X
W
W
q
Z
L
"}
(3,1,1) = {"
L
b
m
m
m
m
I
n
"}
(4,1,1) = {"
L
a
x
x
x
x
P
L
"}
(5,1,1) = {"
L
L
L
M
M
L
L
L
"}
(6,1,1) = {"
L
O
T
T
T
T
O
L
"}
(7,1,1) = {"
L
T
H
z
z
f
T
L
"}
(8,1,1) = {"
L
K
c
g
g
l
h
L
"}
(9,1,1) = {"
L
T
d
t
t
w
T
L
"}
(10,1,1) = {"
L
u
V
T
T
V
u
L
"}
(11,1,1) = {"
L
L
L
C
C
L
L
L
"}
(12,1,1) = {"
L
G
y
U
U
y
G
L
"}
(13,1,1) = {"
L
R
o
o
o
o
A
L
"}
(14,1,1) = {"
L
N
o
Q
Q
o
e
L
"}
(15,1,1) = {"
L
G
E
J
F
p
G
L
"}
(16,1,1) = {"
L
L
L
L
L
L
L
L
"}
