//MAP CONVERTED BY dmm2tgm.py THIS HEADER COMMENT PREVENTS RECONVERSION, DO NOT REMOVE
"b" = (
/obj/machinery/door/airlock/silver,
/turf/open/floor/wood,
/area/city/backstreets_room)
"c" = (
/obj/structure/window/reinforced/survival_pod{
	desc = "Shrimply too strong.";
	dir = 4;
	max_integrity = 10000;
	name = "shrimp display window"
	},
/mob/living/simple_animal/hostile/shrimp_soldier,
/turf/open/floor/plasteel/rockvault/alien{
	name = "floor"
	},
/area/city/backstreets_room)
"d" = (
/obj/item/reagent_containers/food/drinks/soda_cans/wellcheers_purple,
/obj/machinery/light{
	dir = 1
	},
/obj/structure/table/wood/poker,
/obj/structure/window/reinforced,
/turf/open/floor/mineral/gold,
/area/city/backstreets_room)
"f" = (
/turf/open/floor/carpet/purple,
/area/city/backstreets_room)
"g" = (
/obj/structure/sign/poster/lobotomycorp/wellcheers,
/turf/closed/indestructible/reinforced,
/area/city/backstreets_room)
"m" = (
/obj/machinery/door/airlock/silver/glass,
/turf/open/floor/plasteel/shuttle{
	name = "floor"
	},
/area/city/backstreets_room)
"n" = (
/obj/item/reagent_containers/food/drinks/soda_cans/wellcheers_red,
/obj/structure/table/wood/poker,
/obj/structure/window/reinforced,
/turf/open/floor/mineral/gold,
/area/city/backstreets_room)
"r" = (
/obj/structure/chair/office,
/mob/living/simple_animal/hostile/shrimp,
/turf/open/floor/carpet/purple,
/area/city/backstreets_room)
"t" = (
/obj/effect/turf_decal/siding/purple{
	dir = 6
	},
/obj/structure/table/glass,
/obj/item/kirbyplants/random{
	pixel_y = 10
	},
/turf/open/floor/carpet/purple,
/area/city/backstreets_room)
"v" = (
/obj/effect/turf_decal/siding/purple{
	dir = 8
	},
/obj/structure/table/wood/fancy/purple,
/obj/item/paper_bin,
/obj/item/pen,
/turf/open/floor/carpet/purple,
/area/city/backstreets_room)
"w" = (
/obj/effect/turf_decal/siding/purple{
	dir = 10
	},
/obj/structure/table/glass,
/obj/item/kirbyplants/random{
	pixel_y = 10
	},
/turf/open/floor/carpet/purple,
/area/city/backstreets_room)
"C" = (
/obj/effect/turf_decal/siding/purple{
	dir = 7
	},
/turf/open/floor/carpet/purple,
/area/city/backstreets_room)
"D" = (
/obj/structure/table/glass,
/obj/item/grenade/spawnergrenade/shrimp/super,
/turf/open/floor/plasteel/vaporwave,
/area/city/backstreets_room)
"F" = (
/obj/machinery/light{
	dir = 4
	},
/obj/structure/window/reinforced/survival_pod{
	desc = "Shrimply too strong.";
	dir = 1;
	max_integrity = 10000;
	name = "shrimp display window"
	},
/obj/structure/lootcrate/s_corp,
/turf/open/floor/plasteel/vaporwave,
/area/city/backstreets_room)
"J" = (
/obj/structure/lootcrate/s_corp,
/turf/open/floor/plasteel/vaporwave,
/area/city/backstreets_room)
"L" = (
/turf/closed/indestructible/reinforced,
/area/city/backstreets_room)
"M" = (
/obj/effect/turf_decal/siding/purple{
	dir = 8
	},
/turf/open/floor/carpet/purple,
/area/city/backstreets_room)
"N" = (
/mob/living/simple_animal/hostile/shrimp_soldier,
/turf/open/floor/plasteel/vaporwave,
/area/city/backstreets_room)
"O" = (
/obj/effect/turf_decal/siding/purple{
	dir = 4
	},
/turf/open/floor/carpet/purple,
/area/city/backstreets_room)
"S" = (
/obj/structure/table/wood/fancy/purple,
/obj/item/gun/ego_gun/sodashotty,
/turf/open/floor/carpet/purple,
/area/city/backstreets_room)
"W" = (
/obj/structure/lootcrate/s_corp,
/turf/open/floor/plasteel/rockvault/alien{
	name = "floor"
	},
/area/city/backstreets_room)
"X" = (
/obj/machinery/light{
	dir = 4
	},
/obj/structure/window/reinforced/survival_pod{
	desc = "Shrimply too strong.";
	max_integrity = 10000;
	name = "shrimp display window"
	},
/obj/structure/lootcrate/s_corp,
/turf/open/floor/plasteel/vaporwave,
/area/city/backstreets_room)
"Y" = (
/obj/item/reagent_containers/food/drinks/soda_cans/wellcheers_white,
/obj/structure/table/wood/poker,
/obj/structure/window/reinforced,
/turf/open/floor/mineral/gold,
/area/city/backstreets_room)
"Z" = (
/mob/living/simple_animal/hostile/shrimp_soldier,
/turf/open/floor/plasteel/rockvault/alien{
	name = "floor"
	},
/area/city/backstreets_room)

(1,1,1) = {"
L
L
L
L
L
L
L
L
"}
(2,1,1) = {"
L
n
M
M
v
M
w
g
"}
(3,1,1) = {"
L
d
f
r
S
f
C
m
"}
(4,1,1) = {"
L
Y
O
O
O
O
t
g
"}
(5,1,1) = {"
L
L
b
L
L
L
L
L
"}
(6,1,1) = {"
L
J
N
N
N
N
J
L
"}
(7,1,1) = {"
L
J
Z
Z
Z
Z
J
L
"}
(8,1,1) = {"
L
J
Z
Z
Z
Z
J
L
"}
(9,1,1) = {"
L
J
Z
W
W
Z
J
L
"}
(10,1,1) = {"
L
J
Z
W
W
Z
J
L
"}
(11,1,1) = {"
L
J
Z
W
W
Z
J
L
"}
(12,1,1) = {"
L
J
Z
W
W
Z
J
L
"}
(13,1,1) = {"
L
J
Z
Z
Z
Z
J
L
"}
(14,1,1) = {"
L
J
Z
c
c
Z
J
L
"}
(15,1,1) = {"
L
J
X
D
D
F
J
L
"}
(16,1,1) = {"
L
L
L
L
L
L
L
L
"}
