//MAP CONVERTED BY dmm2tgm.py THIS HEADER COMMENT PREVENTS RECONVERSION, DO NOT REMOVE
"a" = (
/turf/closed/indestructible/reinforced,
/area/city/backstreets_room)
"b" = (
/obj/effect/turf_decal/siding/brown{
	dir = 10
	},
/obj/effect/decal/cleanable/dirt/dust,
/turf/open/floor/sepia,
/area/city/backstreets_room)
"c" = (
/obj/effect/turf_decal/box/red,
/obj/structure/closet/crate/freezer/surplus_limbs,
/obj/effect/decal/cleanable/cobweb,
/turf/open/floor/plating/rust,
/area/city/backstreets_room)
"e" = (
/obj/effect/turf_decal/siding/brown{
	dir = 1
	},
/obj/effect/decal/cleanable/dirt/dust,
/mob/living/simple_animal/hostile/clan/defender{
	charge = 10
	},
/obj/effect/landmark/npc_reveal_sensor{
	sensor_id = "storage";
	cooldown_duration = 6000
	},
/turf/open/floor/sepia,
/area/city/backstreets_room)
"h" = (
/obj/structure/sign/plaques/kiddie/perfect_drone{
	desc = "The image has been warn down from the weathering of time.";
	pixel_y = 32
	},
/obj/effect/landmark/npc_reveal_spawn{
	mobtype = /mob/living/simple_animal/npc/tinkerer;
	sensor_id = "storage"
	},
/turf/open/floor/plating/rust,
/area/city/backstreets_room)
"k" = (
/obj/effect/turf_decal/siding/brown{
	dir = 4
	},
/obj/effect/decal/cleanable/dirt/dust,
/turf/open/floor/sepia,
/area/city/backstreets_room)
"n" = (
/obj/effect/turf_decal/siding/brown{
	dir = 6
	},
/obj/effect/decal/cleanable/dirt/dust,
/turf/open/floor/sepia,
/area/city/backstreets_room)
"p" = (
/obj/effect/turf_decal/siding/brown{
	dir = 5
	},
/obj/effect/decal/cleanable/dirt/dust,
/turf/open/floor/sepia,
/area/city/backstreets_room)
"r" = (
/turf/open/floor/plating/rust,
/area/city/backstreets_room)
"s" = (
/obj/effect/turf_decal/box/red,
/obj/effect/landmark/cratespawn/corpo,
/turf/open/floor/plating/rust,
/area/city/backstreets_room)
"t" = (
/obj/effect/turf_decal/box/red,
/obj/structure/lootcrate/money,
/turf/open/floor/plating/rust,
/area/city/backstreets_room)
"v" = (
/obj/structure/fluff/clockwork/fallen_armor,
/obj/effect/turf_decal/box/white,
/turf/open/floor/plating/rust,
/area/city/backstreets_room)
"w" = (
/obj/structure/mineral_door/iron,
/obj/effect/decal/cleanable/dirt/dust,
/turf/open/floor/plasteel/stairs/left{
	dir = 4
	},
/area/city/backstreets_room)
"D" = (
/obj/effect/turf_decal/siding/brown,
/obj/effect/decal/cleanable/dirt/dust,
/obj/structure/fluff/paper,
/turf/open/floor/sepia,
/area/city/backstreets_room)
"G" = (
/obj/effect/turf_decal/siding/brown{
	dir = 8
	},
/obj/effect/decal/cleanable/dirt/dust,
/turf/open/floor/sepia,
/area/city/backstreets_room)
"H" = (
/obj/structure/table/bronze,
/obj/item/clothing/suit/armor/ego_gear/city/azure_armor,
/obj/item/clothing/suit/armor/ego_gear/city/azure_armor,
/obj/item/taperecorder/empty,
/turf/open/floor/plating/rust,
/area/city/backstreets_room)
"I" = (
/mob/living/simple_animal/hostile/clan/scout,
/obj/effect/decal/cleanable/dirt/dust,
/turf/open/floor/sepia,
/area/city/backstreets_room)
"J" = (
/obj/effect/turf_decal/siding/brown{
	dir = 9
	},
/obj/effect/decal/cleanable/dirt/dust,
/obj/structure/fluff/paper/stack,
/turf/open/floor/sepia,
/area/city/backstreets_room)
"L" = (
/obj/structure/table/bronze,
/obj/item/tape/resurgence/temple_of_motus,
/turf/open/floor/plating/rust,
/area/city/backstreets_room)
"M" = (
/obj/effect/decal/cleanable/dirt/dust,
/turf/open/floor/plasteel/stairs/left{
	dir = 8
	},
/area/city/backstreets_room)
"Q" = (
/mob/living/simple_animal/hostile/clan/scout,
/obj/effect/decal/cleanable/dirt/dust,
/turf/open/floor/plasteel/stairs/left{
	dir = 8
	},
/area/city/backstreets_room)
"S" = (
/obj/effect/turf_decal/siding/brown{
	dir = 4
	},
/obj/effect/decal/cleanable/dirt/dust,
/obj/structure/fluff/paper/stack,
/turf/open/floor/sepia,
/area/city/backstreets_room)
"T" = (
/obj/effect/decal/cleanable/cobweb/cobweb2,
/turf/open/floor/plating/rust,
/area/city/backstreets_room)
"V" = (
/obj/structure/fluff/paper/corner,
/mob/living/simple_animal/hostile/clan/drone,
/turf/open/floor/plating/rust,
/area/city/backstreets_room)
"W" = (
/obj/structure/mineral_door/iron,
/turf/open/floor/plating/rust,
/area/city/backstreets_room)
"X" = (
/obj/effect/decal/cleanable/dirt/dust,
/turf/open/floor/sepia,
/area/city/backstreets_room)
"Y" = (
/obj/structure/sign/poster/lobotomycorp/cleancorpses{
	desc = "It's far too late for this, isn't it?"
	},
/turf/closed/indestructible/reinforced,
/area/city/backstreets_room)

(1,1,1) = {"
a
a
a
a
a
a
"}
(2,1,1) = {"
a
c
t
s
v
a
"}
(3,1,1) = {"
a
T
r
r
r
a
"}
(4,1,1) = {"
a
a
Y
a
w
a
"}
(5,1,1) = {"
a
J
G
G
b
a
"}
(6,1,1) = {"
W
e
X
I
D
a
"}
(7,1,1) = {"
a
p
k
S
n
a
"}
(8,1,1) = {"
a
Q
M
M
M
a
"}
(9,1,1) = {"
a
h
H
L
V
a
"}
(10,1,1) = {"
a
a
a
a
a
a
"}
