//MAP CONVERTED BY dmm2tgm.py THIS HEADER COMMENT PREVENTS RECONVERSION, DO NOT REMOVE
"a" = (
/obj/effect/decal/cleanable/dirt/dust,
/obj/machinery/door/airlock/cult/unruned/friendly,
/turf/open/indestructible/cult,
/area/city/backstreets_room)
"g" = (
/obj/structure/trap/stun,
/obj/effect/decal/cleanable/dirt/dust,
/turf/open/floor/plasteel/stairs{
	dir = 8
	},
/area/city/backstreets_room)
"o" = (
/obj/effect/decal/cleanable/dirt/dust,
/turf/closed/indestructible/reinforced,
/area/city/backstreets_room)
"u" = (
/obj/effect/decal/cleanable/dirt/dust,
/mob/living/simple_animal/hostile/ordeal/bigBirdEye,
/turf/open/indestructible/cult,
/area/city/backstreets_room)
"z" = (
/obj/effect/decal/cleanable/blood,
/obj/effect/decal/cleanable/dirt/dust,
/mob/living/simple_animal/hostile/ordeal/bigBirdEye,
/turf/open/indestructible/cult,
/area/city/backstreets_room)
"A" = (
/obj/effect/decal/cleanable/dirt/dust,
/turf/closed/wall/mineral/cult,
/area/city/backstreets_room)
"C" = (
/obj/effect/mob_spawn/human/corpse/assistant,
/turf/open/indestructible/cult,
/area/city/backstreets_room)
"E" = (
/turf/open/indestructible/cult,
/area/city/backstreets_room)
"H" = (
/obj/effect/decal/cleanable/blood,
/obj/item/book/codex_gigas,
/turf/open/indestructible/cult,
/area/city/backstreets_room)
"K" = (
/obj/effect/decal/cleanable/cobweb{
	layer = 5
	},
/turf/closed/indestructible/reinforced,
/area/city/backstreets_room)
"L" = (
/mob/living/simple_animal/hostile/ordeal/bigBirdEye,
/turf/open/indestructible/cult,
/area/city/backstreets_room)
"M" = (
/obj/effect/decal/cleanable/cobweb/cobweb2{
	layer = 5
	},
/obj/effect/landmark/cratespawn,
/turf/open/indestructible/cult,
/area/city/backstreets_room)
"N" = (
/obj/effect/decal/cleanable/dirt/dust,
/obj/effect/landmark/cratespawn,
/turf/open/indestructible/cult,
/area/city/backstreets_room)
"Q" = (
/turf/closed/indestructible/reinforced,
/area/city/backstreets_room)
"X" = (
/obj/effect/decal/cleanable/dirt/dust,
/turf/open/indestructible/cult,
/area/city/backstreets_room)
"Y" = (
/turf/closed/wall/mineral/cult,
/area/city/backstreets_room)

(1,1,1) = {"
Y
Y
Y
Y
Y
Y
"}
(2,1,1) = {"
a
X
X
E
E
Y
"}
(3,1,1) = {"
Q
K
Y
Y
g
Y
"}
(4,1,1) = {"
Y
L
E
E
X
Y
"}
(5,1,1) = {"
Y
L
E
E
X
Y
"}
(6,1,1) = {"
Q
L
E
E
N
A
"}
(7,1,1) = {"
Q
X
u
Y
Y
o
"}
(8,1,1) = {"
Y
L
E
H
C
Y
"}
(9,1,1) = {"
Y
M
X
X
z
Y
"}
(10,1,1) = {"
Q
Y
Q
Y
Y
Y
"}
