//MAP CONVERTED BY dmm2tgm.py THIS HEADER COMMENT PREVENTS RECONVERSION, DO NOT REMOVE
"a" = (
/obj/structure/mineral_door/wood,
/turf/closed/indestructible/fakedoor,
/area/city/backstreets_room)
"c" = (
/mob/living/simple_animal/hostile/lovetown,
/turf/open/floor/wood,
/area/city/backstreets_room)
"d" = (
/obj/effect/turf_decal/siding/wood,
/obj/effect/decal/cleanable/blood/tracks{
	dir = 10
	},
/turf/open/floor/wood,
/area/city/backstreets_room)
"f" = (
/obj/effect/decal/cleanable/blood,
/turf/open/floor/wood,
/area/city/backstreets_room)
"g" = (
/obj/structure/grille,
/obj/structure/barricade/wooden/crude,
/obj/structure/barricade/wooden,
/turf/open/floor/plating/dirt,
/area/city/backstreets_room)
"i" = (
/obj/effect/decal/cleanable/blood/footprints{
	dir = 4;
	pixel_x = -6;
	pixel_y = 8
	},
/obj/effect/decal/cleanable/blood/footprints{
	dir = 4;
	pixel_x = -6;
	pixel_y = 8
	},
/obj/effect/decal/cleanable/blood/footprints{
	dir = 4
	},
/obj/effect/decal/cleanable/blood/footprints{
	dir = 4;
	pixel_x = 14;
	pixel_y = 4
	},
/obj/structure/barricade/wooden,
/turf/open/floor/wood,
/area/city/backstreets_room)
"j" = (
/obj/structure/table/wood,
/turf/open/floor/wood,
/area/city/backstreets_room)
"k" = (
/turf/open/floor/wood{
	icon_state = "wood-broken7"
	},
/area/city/backstreets_room)
"l" = (
/obj/effect/decal/cleanable/blood/gibs/core,
/turf/open/floor/wood,
/area/city/backstreets_room)
"m" = (
/obj/effect/turf_decal/siding/wood,
/turf/open/floor/wood,
/area/city/backstreets_room)
"q" = (
/obj/effect/turf_decal/siding/wood,
/obj/effect/decal/cleanable/blood/gibs/up,
/turf/open/floor/wood,
/area/city/backstreets_room)
"r" = (
/obj/effect/turf_decal/siding/wood,
/obj/effect/decal/cleanable/blood/gibs/torso,
/turf/open/floor/wood,
/area/city/backstreets_room)
"t" = (
/obj/item/chair/wood/wings,
/turf/open/floor/wood,
/area/city/backstreets_room)
"u" = (
/obj/structure/table/wood,
/obj/item/ego_weapon/city/rats/knife,
/turf/open/floor/wood,
/area/city/backstreets_room)
"x" = (
/turf/open/floor/wood,
/area/city/backstreets_room)
"B" = (
/obj/effect/decal/cleanable/blood/tracks,
/turf/open/floor/wood{
	icon_state = "wood-broken7"
	},
/area/city/backstreets_room)
"F" = (
/obj/effect/decal/cleanable/blood{
	pixel_x = 8;
	pixel_y = 11
	},
/turf/open/floor/wood,
/area/city/backstreets_room)
"H" = (
/obj/effect/turf_decal/siding/wood,
/mob/living/simple_animal/hostile/lovetown,
/turf/open/floor/wood,
/area/city/backstreets_room)
"I" = (
/obj/structure/barricade/wooden,
/turf/open/floor/wood{
	icon_state = "wood-broken"
	},
/area/city/backstreets_room)
"J" = (
/obj/effect/decal/cleanable/blood/footprints{
	dir = 4;
	pixel_x = -6;
	pixel_y = 8
	},
/obj/effect/decal/cleanable/blood/footprints{
	dir = 4;
	pixel_x = -6;
	pixel_y = 8
	},
/obj/effect/decal/cleanable/blood/footprints{
	dir = 4;
	pixel_x = 14;
	pixel_y = 4
	},
/obj/structure/barricade/wooden,
/turf/open/floor/wood,
/area/city/backstreets_room)
"K" = (
/obj/effect/turf_decal/siding/wood,
/obj/effect/bloodpool,
/mob/living/simple_animal/hostile/lovetown,
/turf/open/floor/wood,
/area/city/backstreets_room)
"M" = (
/obj/effect/decal/cleanable/blood/footprints{
	pixel_x = -3
	},
/obj/structure/barricade/wooden,
/turf/open/floor/wood{
	icon_state = "wood-broken6"
	},
/area/city/backstreets_room)
"P" = (
/obj/effect/decal/cleanable/blood/splatter,
/turf/open/floor/wood,
/area/city/backstreets_room)
"Q" = (
/turf/closed/indestructible/reinforced,
/area/city/backstreets_room)
"V" = (
/obj/effect/decal/cleanable/blood/gibs/old,
/turf/open/floor/wood,
/area/city/backstreets_room)
"Y" = (
/obj/structure/lootcrate/money,
/turf/open/floor/wood{
	icon_state = "wood-broken"
	},
/area/city/backstreets_room)

(1,1,1) = {"
Q
Q
Q
Q
Q
Q
"}
(2,1,1) = {"
a
i
x
I
m
Q
"}
(3,1,1) = {"
Q
J
M
B
d
Q
"}
(4,1,1) = {"
Q
u
j
x
r
Q
"}
(5,1,1) = {"
Q
V
x
k
q
Q
"}
(6,1,1) = {"
g
x
c
t
m
Q
"}
(7,1,1) = {"
Q
f
x
F
K
Q
"}
(8,1,1) = {"
Q
P
Y
l
m
Q
"}
(9,1,1) = {"
Q
c
x
x
H
Q
"}
(10,1,1) = {"
Q
Q
Q
Q
Q
Q
"}
