//MAP CONVERTED BY dmm2tgm.py THIS HEADER COMMENT PREVENTS RECONVERSION, DO NOT REMOVE
"bS" = (
/obj/effect/turf_decal/siding/wood{
	dir = 9
	},
/obj/effect/decal/cleanable/dirt/dust,
/turf/open/floor/carpet/black,
/area/city/backstreets_room)
"cf" = (
/obj/structure/table/wood,
/obj/item/modular_computer/laptop{
	desc = "Appears to be a fixers laptop.";
	name = "Fixer Laptop"
	},
/turf/open/floor/wood,
/area/city/backstreets_room)
"cn" = (
/obj/structure/grille/broken,
/obj/item/stack/sheet/mineral/wood,
/obj/item/shard,
/obj/item/stack/sheet/silk,
/obj/item/weaponcrafting/silkstring,
/turf/open/floor/plating,
/area/city/backstreets_room)
"cX" = (
/obj/effect/turf_decal/siding/wood{
	dir = 8
	},
/mob/living/simple_animal/hostile/ordeal/amber_bug{
	name = "carnivorous worm"
	},
/obj/effect/decal/cleanable/dirt/dust,
/turf/open/floor/plasteel/sepia,
/area/city/backstreets_room)
"dh" = (
/obj/effect/turf_decal/siding/wood{
	dir = 5
	},
/obj/effect/decal/cleanable/dirt/dust,
/turf/open/floor/carpet/black,
/area/city/backstreets_room)
"dR" = (
/obj/effect/turf_decal/siding/wood{
	dir = 4
	},
/obj/effect/decal/cleanable/dirt/dust,
/turf/open/floor/carpet/black,
/area/city/backstreets_room)
"ef" = (
/obj/effect/decal/cleanable/dirt/dust,
/obj/structure/closet/crate/bin,
/turf/open/floor/wood,
/area/city/backstreets_room)
"gZ" = (
/obj/effect/turf_decal/siding/wood{
	dir = 7
	},
/turf/open/floor/carpet/black,
/area/city/backstreets_room)
"hx" = (
/obj/effect/turf_decal/weather/dirt{
	dir = 3
	},
/turf/open/floor/wood,
/area/city/backstreets_room)
"hI" = (
/obj/structure/closet/secure_closet/freezer/gulag_fridge,
/obj/effect/decal/cleanable/dirt/dust,
/turf/open/floor/plasteel/sepia,
/area/city/backstreets_room)
"hQ" = (
/obj/effect/turf_decal/weather/dirt{
	dir = 5
	},
/obj/effect/turf_decal/weather/dirt{
	dir = 10
	},
/mob/living/simple_animal/hostile/ordeal/amber_bug{
	name = "carnivorous worm"
	},
/obj/item/food/meat/slab/human/mutant/skeleton,
/turf/open/floor/fakepit,
/area/city/backstreets_room)
"iL" = (
/obj/effect/turf_decal/siding/wood{
	dir = 6
	},
/turf/open/floor/carpet/black,
/area/city/backstreets_room)
"iM" = (
/obj/structure/chair/sofa/left{
	dir = 1
	},
/turf/open/floor/wood,
/area/city/backstreets_room)
"jR" = (
/obj/effect/turf_decal/siding/wood{
	dir = 7
	},
/obj/effect/turf_decal/siding/wood{
	dir = 8
	},
/turf/open/floor/carpet/black,
/area/city/backstreets_room)
"jU" = (
/obj/structure/chair/sofa/right{
	dir = 1
	},
/turf/open/floor/wood,
/area/city/backstreets_room)
"kw" = (
/mob/living/simple_animal/hostile/ordeal/amber_bug{
	name = "carnivorous worm"
	},
/turf/open/floor/wood,
/area/city/backstreets_room)
"lJ" = (
/obj/effect/turf_decal/weather/dirt{
	dir = 3
	},
/mob/living/simple_animal/hostile/ordeal/amber_bug{
	name = "carnivorous worm"
	},
/turf/open/floor/wood,
/area/city/backstreets_room)
"mN" = (
/obj/effect/decal/cleanable/dirt/dust,
/obj/item/kirbyplants/dead{
	desc = "A sad, dead plant";
	name = "dead potted plant";
	pixel_y = 10
	},
/turf/open/floor/wood,
/area/city/backstreets_room)
"ni" = (
/obj/effect/turf_decal/siding/wood{
	dir = 1
	},
/obj/structure/table/greyscale,
/turf/open/floor/plasteel/sepia,
/area/city/backstreets_room)
"qG" = (
/mob/living/simple_animal/hostile/ordeal/amber_bug{
	name = "carnivorous worm"
	},
/obj/item/food/meat/slab/human/mutant/skeleton,
/turf/open/floor/plating/dirt/jungle/dark,
/area/city/backstreets_room)
"sI" = (
/obj/structure/table/greyscale,
/obj/machinery/microwave{
	pixel_y = 7
	},
/obj/effect/decal/cleanable/dirt/dust,
/obj/effect/decal/cleanable/dirt/dust,
/turf/open/floor/plasteel/sepia,
/area/city/backstreets_room)
"uU" = (
/obj/structure/table/wood,
/obj/effect/decal/cleanable/dirt/dust,
/obj/item/clothing/head/collectable/petehat,
/turf/open/floor/wood,
/area/city/backstreets_room)
"zv" = (
/turf/closed/indestructible/reinforced,
/area/city/backstreets_room)
"zT" = (
/obj/effect/mob_spawn/human/skeleton/alive,
/obj/effect/decal/cleanable/blood/old,
/obj/effect/decal/cleanable/blood/old{
	pixel_y = -20
	},
/turf/open/floor/wood,
/area/city/backstreets_room)
"Ak" = (
/obj/effect/decal/cleanable/dirt/dust,
/obj/structure/table/wood,
/obj/item/paper_bin,
/obj/item/paper_bin/carbon{
	pixel_x = -14
	},
/obj/item/paper_bin/construction{
	pixel_x = 14
	},
/turf/open/floor/wood,
/area/city/backstreets_room)
"BI" = (
/obj/effect/decal/cleanable/blood/old{
	pixel_x = 17;
	pixel_y = -7
	},
/turf/open/floor/wood,
/area/city/backstreets_room)
"Cl" = (
/obj/effect/turf_decal/siding/wood{
	dir = 8
	},
/turf/open/floor/plasteel/sepia,
/area/city/backstreets_room)
"Cx" = (
/turf/open/floor/wood,
/area/city/backstreets_room)
"CK" = (
/obj/item/stack/sheet/mineral/wood,
/turf/open/floor/wood,
/area/city/backstreets_room)
"CM" = (
/mob/living/simple_animal/hostile/ordeal/amber_bug{
	name = "carnivorous worm"
	},
/obj/effect/decal/cleanable/dirt/dust,
/turf/open/floor/plasteel/sepia,
/area/city/backstreets_room)
"Fn" = (
/obj/effect/turf_decal/siding/wood{
	dir = 9
	},
/obj/structure/table/greyscale,
/turf/open/floor/plasteel/sepia,
/area/city/backstreets_room)
"Ir" = (
/obj/structure/table/wood,
/obj/effect/decal/cleanable/dirt/dust,
/obj/item/kirbyplants/dead{
	desc = "A sad, dead plant";
	name = "dead potted plant";
	pixel_y = 10
	},
/turf/open/floor/wood,
/area/city/backstreets_room)
"IG" = (
/obj/effect/turf_decal/weather/dirt{
	dir = 8
	},
/mob/living/simple_animal/hostile/ordeal/amber_bug{
	name = "carnivorous worm"
	},
/turf/open/floor/wood,
/area/city/backstreets_room)
"KS" = (
/obj/effect/decal/cleanable/blood/old{
	pixel_x = -13;
	pixel_y = -7
	},
/turf/open/floor/wood,
/area/city/backstreets_room)
"Le" = (
/obj/effect/decal/cleanable/dirt/dust,
/turf/open/floor/carpet/black,
/area/city/backstreets_room)
"Lg" = (
/obj/effect/decal/cleanable/dirt/dust,
/obj/effect/decal/cleanable/dirt/dust,
/obj/effect/decal/cleanable/dirt/dust,
/obj/structure/closet/cabinet,
/obj/item/clothing/suit/armor/ego_gear/city/seven,
/turf/open/floor/wood,
/area/city/backstreets_room)
"Ov" = (
/obj/structure/table/wood,
/obj/item/ego_weapon/city/streetlight_greatsword,
/turf/open/floor/wood,
/area/city/backstreets_room)
"PM" = (
/obj/structure/bed,
/obj/item/bedsheet/clown,
/obj/effect/decal/cleanable/dirt/dust,
/obj/effect/decal/cleanable/dirt/dust,
/turf/open/floor/wood,
/area/city/backstreets_room)
"PN" = (
/obj/structure/mineral_door/wood,
/turf/open/floor/wood,
/area/city/backstreets_room)
"Qb" = (
/obj/item/paper/crumpled,
/obj/item/paper/crumpled{
	pixel_x = 5;
	pixel_y = -5
	},
/obj/item/paper/crumpled{
	pixel_x = -10
	},
/obj/item/paper/crumpled/muddy{
	pixel_x = -15;
	pixel_y = 10
	},
/obj/item/paper/crumpled/muddy{
	pixel_x = 10
	},
/obj/item/paper/crumpled/muddy{
	pixel_x = -8;
	pixel_y = -7
	},
/turf/open/floor/wood,
/area/city/backstreets_room)
"QG" = (
/obj/effect/decal/cleanable/dirt/dust,
/turf/open/floor/wood,
/area/city/backstreets_room)
"Rp" = (
/mob/living/simple_animal/hostile/ordeal/amber_bug{
	name = "carnivorous worm"
	},
/obj/structure/chair/comfy/black,
/turf/open/floor/wood,
/area/city/backstreets_room)
"SZ" = (
/obj/structure/chair/sofa{
	dir = 1
	},
/turf/open/floor/wood,
/area/city/backstreets_room)
"Tx" = (
/mob/living/simple_animal/hostile/ordeal/amber_bug{
	name = "carnivorous worm"
	},
/turf/open/floor/plasteel/sepia,
/area/city/backstreets_room)
"Vw" = (
/obj/effect/decal/cleanable/blood/old{
	pixel_y = -20
	},
/obj/structure/table/wood,
/obj/item/folder/syndicate/red{
	desc = "A folder belonging to one of the City's corporations.";
	name = "Corporation Folder";
	pixel_x = 5;
	pixel_y = -2
	},
/obj/item/pen/edagger{
	desc = "This pen looks sharper than usual...";
	name = "Sharp Pen"
	},
/turf/open/floor/wood,
/area/city/backstreets_room)
"Wm" = (
/turf/open/floor/plating/dirt/jungle/dark,
/area/city/backstreets_room)
"WL" = (
/obj/effect/decal/cleanable/dirt/dust,
/obj/effect/decal/cleanable/dirt/dust,
/obj/item/kirbyplants/dead{
	desc = "A sad, dead plant";
	name = "dead potted plant";
	pixel_y = 10
	},
/turf/open/floor/wood,
/area/city/backstreets_room)
"Xw" = (
/obj/structure/table/wood,
/obj/structure/showcase/machinery/tv{
	desc = "Guess robots can't fix their lesser machinery.";
	name = "\improper Broken TV";
	pixel_x = 2;
	pixel_y = 5
	},
/turf/open/floor/wood,
/area/city/backstreets_room)
"Yf" = (
/obj/effect/turf_decal/weather/dirt{
	dir = 8
	},
/turf/open/floor/wood,
/area/city/backstreets_room)
"YJ" = (
/obj/effect/turf_decal/siding/wood{
	dir = 8
	},
/turf/open/floor/carpet/black,
/area/city/backstreets_room)
"Zp" = (
/turf/open/floor/carpet/black,
/area/city/backstreets_room)

(1,1,1) = {"
zv
zv
zv
zv
zv
zv
zv
zv
"}
(2,1,1) = {"
zv
Ir
uU
Ir
lJ
Wm
hQ
zv
"}
(3,1,1) = {"
zv
bS
YJ
jR
hx
qG
Wm
zv
"}
(4,1,1) = {"
CK
Zp
Le
gZ
Cx
Yf
IG
zv
"}
(5,1,1) = {"
zv
dh
dR
iL
Cx
Cx
Cx
zv
"}
(6,1,1) = {"
zv
ef
kw
Cx
kw
Cx
Cx
zv
"}
(7,1,1) = {"
cn
Cx
Cx
QG
Fn
Cl
cX
zv
"}
(8,1,1) = {"
cn
Cx
kw
Cx
ni
Tx
CM
zv
"}
(9,1,1) = {"
zv
mN
Cx
QG
ni
sI
hI
zv
"}
(10,1,1) = {"
zv
zv
PN
zv
zv
zv
zv
zv
"}
(11,1,1) = {"
zv
WL
Cx
QG
QG
zT
PM
zv
"}
(12,1,1) = {"
cn
Cx
kw
iM
Cx
BI
KS
zv
"}
(13,1,1) = {"
cn
Xw
Cx
SZ
Cx
Ov
Vw
zv
"}
(14,1,1) = {"
cn
Cx
Cx
jU
Cx
Rp
cf
zv
"}
(15,1,1) = {"
zv
Lg
Cx
QG
Cx
Qb
Ak
zv
"}
(16,1,1) = {"
zv
zv
zv
zv
zv
zv
zv
zv
"}
