//MAP CONVERTED BY dmm2tgm.py THIS HEADER COMMENT PREVENTS RECONVERSION, DO NOT REMOVE
"a" = (
/obj/structure/window/reinforced{
	dir = 4
	},
/obj/structure/lattice/catwalk,
/turf/open/lava/smooth,
/area/city/backstreets_room)
"b" = (
/obj/structure/window/reinforced{
	dir = 1
	},
/obj/effect/turf_decal/raven{
	dir = 5
	},
/obj/structure/fluff/big_chain{
	pixel_y = 10
	},
/turf/open/floor/holofloor/dark,
/area/city/backstreets_room)
"c" = (
/obj/machinery/door/poddoor,
/turf/closed/indestructible/fakeglass,
/area/city/backstreets_room)
"d" = (
/obj/structure/lattice/catwalk,
/obj/structure/rack,
/obj/item/organ/ears/cybernetic,
/obj/item/organ/ears/cybernetic/upgraded,
/turf/open/floor/holofloor/dark,
/area/city/backstreets_room)
"e" = (
/obj/structure/destructible/cult/forge{
	desc = "A forge used in crafting various fixer equipment.";
	name = "workshop forge"
	},
/obj/structure/window/reinforced{
	dir = 1
	},
/obj/effect/turf_decal/raven{
	dir = 1
	},
/turf/open/floor/holofloor/dark,
/area/city/backstreets_room)
"f" = (
/obj/structure/lattice/catwalk,
/obj/structure/rack,
/obj/item/stack/sheet/plasteel/fifty,
/turf/open/floor/holofloor/dark,
/area/city/backstreets_room)
"g" = (
/obj/structure/lattice/catwalk,
/obj/structure/closet/secure_closet/mechanicus/augs,
/turf/open/floor/holofloor/dark,
/area/city/backstreets_room)
"h" = (
/obj/effect/turf_decal/siding/thinplating{
	dir = 8
	},
/obj/structure/table_frame,
/obj/item/shard,
/turf/open/floor/carpet/black,
/area/city/backstreets_room)
"i" = (
/obj/effect/decal/cleanable/cobweb,
/obj/effect/decal/cleanable/dirt/dust,
/turf/open/floor/holofloor/dark,
/area/city/backstreets_room)
"j" = (
/obj/structure/lattice/catwalk,
/obj/structure/rack,
/obj/item/stack/sheet/plastitaniumglass,
/obj/item/stack/sheet/plastitaniumglass,
/obj/item/stack/sheet/plastitaniumglass,
/obj/item/stack/sheet/plastitaniumglass,
/obj/item/stack/sheet/plastitaniumglass{
	pixel_x = -4
	},
/turf/open/floor/holofloor/dark,
/area/city/backstreets_room)
"l" = (
/obj/structure/lattice/catwalk,
/obj/structure/rack,
/obj/item/organ/liver/cybernetic,
/obj/item/organ/liver/cybernetic/tier2,
/obj/item/organ/liver/cybernetic/tier3,
/obj/item/organ/stomach/cybernetic,
/obj/item/organ/stomach/cybernetic/tier2,
/obj/item/organ/stomach/cybernetic/tier3,
/turf/open/floor/holofloor/dark,
/area/city/backstreets_room)
"m" = (
/obj/structure/lattice/catwalk,
/obj/structure/rack,
/obj/item/organ/lungs/cybernetic,
/obj/item/organ/lungs/cybernetic/tier2,
/obj/item/organ/lungs/cybernetic/tier3,
/obj/item/organ/lungs/cybernetic/tier4,
/obj/effect/decal/cleanable/cobweb/cobweb2,
/turf/open/floor/holofloor/dark,
/area/city/backstreets_room)
"n" = (
/obj/machinery/door/airlock/grunge,
/turf/open/floor/holofloor/dark,
/area/city/backstreets_room)
"o" = (
/obj/structure/window/reinforced{
	dir = 1
	},
/obj/effect/turf_decal/raven{
	dir = 9
	},
/obj/structure/fluff/big_chain{
	pixel_y = 10
	},
/turf/open/floor/holofloor/dark,
/area/city/backstreets_room)
"p" = (
/obj/structure/chair/sofa/corp/left{
	dir = 1
	},
/obj/effect/decal/cleanable/dirt/dust,
/turf/open/floor/holofloor/dark,
/area/city/backstreets_room)
"q" = (
/obj/structure/table/glass,
/obj/effect/turf_decal/siding/thinplating{
	dir = 10
	},
/turf/open/floor/carpet/black,
/area/city/backstreets_room)
"r" = (
/obj/structure/lattice/catwalk,
/turf/open/lava/smooth,
/area/city/backstreets_room)
"s" = (
/obj/structure/lattice/catwalk,
/obj/structure/rack,
/obj/item/organ/heart/cybernetic,
/obj/item/organ/heart/cybernetic/tier2,
/obj/item/organ/heart/cybernetic/tier3,
/obj/item/organ/heart/cybernetic/tier4,
/turf/open/floor/holofloor/dark,
/area/city/backstreets_room)
"t" = (
/obj/structure/lattice/catwalk,
/obj/structure/closet/secure_closet/mechanicus/implants,
/turf/open/floor/holofloor/dark,
/area/city/backstreets_room)
"u" = (
/mob/living/simple_animal/hostile/ordeal/green_bot/price{
	desc = "A slim robot that appears to have lost itself and its arm.";
	name = "Corrupted Meister Emett"
	},
/turf/open/floor/holofloor/dark,
/area/city/backstreets_room)
"v" = (
/obj/structure/lattice/catwalk,
/obj/structure/rack,
/obj/item/stack/sheet/metal/fifty,
/turf/open/floor/holofloor/dark,
/area/city/backstreets_room)
"w" = (
/obj/effect/decal/cleanable/dirt,
/turf/open/floor/holofloor/dark,
/area/city/backstreets_room)
"x" = (
/obj/effect/turf_decal/raven{
	dir = 8
	},
/obj/structure/table/reinforced,
/obj/item/stack/sheet/plasteel{
	pixel_x = -10
	},
/obj/item/stack/sheet/plastitaniumglass{
	pixel_x = 5
	},
/turf/open/floor/holofloor/dark,
/area/city/backstreets_room)
"y" = (
/obj/effect/decal/cleanable/dirt/dust,
/turf/open/floor/holofloor/dark,
/area/city/backstreets_room)
"z" = (
/obj/machinery/door/airlock/hatch,
/turf/open/floor/holofloor/dark,
/area/city/backstreets_room)
"A" = (
/obj/structure/chair/office{
	dir = 4
	},
/mob/living/simple_animal/hostile/ordeal/green_bot{
	name = "clerk bot"
	},
/turf/open/floor/holofloor/dark,
/area/city/backstreets_room)
"B" = (
/obj/structure/lattice/catwalk,
/obj/structure/rack,
/obj/item/stack/sheet/titaniumglass,
/obj/item/stack/sheet/titaniumglass,
/obj/item/stack/sheet/titaniumglass,
/obj/item/stack/sheet/titaniumglass,
/obj/item/stack/sheet/titaniumglass,
/turf/open/floor/holofloor/dark,
/area/city/backstreets_room)
"C" = (
/obj/effect/turf_decal/siding/thinplating{
	dir = 9
	},
/turf/open/floor/carpet/black,
/area/city/backstreets_room)
"D" = (
/mob/living/simple_animal/hostile/ordeal/green_bot_big{
	name = "gun bot"
	},
/turf/open/floor/holofloor/dark,
/area/city/backstreets_room)
"E" = (
/obj/effect/turf_decal/siding/thinplating{
	dir = 6
	},
/turf/open/floor/carpet/black,
/area/city/backstreets_room)
"F" = (
/obj/structure/table/reinforced,
/obj/item/ego_weapon/city/rats{
	desc = "A somewhat durable hammer for equipment creation.";
	name = "repurposed hammer"
	},
/obj/effect/turf_decal/raven{
	dir = 8
	},
/obj/item/bodypart/l_arm/robot/surplus{
	desc = "A thin, skeleton arm. Guess that belonged to the robotic meister.";
	name = "broken prosthetic arm"
	},
/turf/open/floor/holofloor/dark,
/area/city/backstreets_room)
"G" = (
/obj/structure/table/glass,
/turf/open/floor/holofloor/dark,
/area/city/backstreets_room)
"H" = (
/obj/structure/table/glass,
/obj/machinery/computer/libraryconsole{
	desc = "For a store in the backstreets, quite progressive.";
	name = "ecash register";
	pixel_y = 10
	},
/obj/effect/turf_decal/siding/thinplating{
	dir = 8
	},
/turf/open/floor/carpet/black,
/area/city/backstreets_room)
"I" = (
/obj/effect/turf_decal/raven{
	dir = 10
	},
/obj/structure/fluff/big_chain{
	pixel_y = 10
	},
/turf/open/floor/holofloor/dark,
/area/city/backstreets_room)
"J" = (
/obj/effect/turf_decal/siding/thinplating{
	dir = 5
	},
/turf/open/floor/carpet/black,
/area/city/backstreets_room)
"K" = (
/obj/effect/turf_decal/raven{
	dir = 4
	},
/turf/open/floor/holofloor/dark,
/area/city/backstreets_room)
"L" = (
/turf/closed/indestructible/reinforced,
/area/city/backstreets_room)
"M" = (
/obj/structure/closet/secure_closet/personal,
/obj/effect/spawner/lootdrop/space/cashmoney,
/obj/effect/spawner/lootdrop/space/cashmoney,
/obj/effect/spawner/lootdrop/space/cashmoney,
/obj/effect/spawner/lootdrop/space/cashmoney,
/obj/effect/spawner/lootdrop/space/cashmoney,
/obj/effect/spawner/lootdrop/space/cashmoney,
/obj/effect/spawner/lootdrop/space/cashmoney,
/obj/effect/spawner/lootdrop/space/cashmoney,
/obj/effect/decal/cleanable/dirt/dust,
/turf/open/floor/holofloor/dark,
/area/city/backstreets_room)
"N" = (
/obj/effect/turf_decal/siding/thinplating{
	dir = 4
	},
/turf/open/floor/carpet/black,
/area/city/backstreets_room)
"O" = (
/obj/structure/fluff/big_chain{
	pixel_y = 10
	},
/obj/effect/turf_decal/raven{
	dir = 6
	},
/turf/open/floor/holofloor/dark,
/area/city/backstreets_room)
"P" = (
/obj/structure/lattice/catwalk,
/obj/structure/rack,
/obj/item/stack/sheet/glass/fifty,
/turf/open/floor/holofloor/dark,
/area/city/backstreets_room)
"Q" = (
/obj/effect/turf_decal/raven{
	dir = 7
	},
/turf/open/floor/holofloor/dark,
/area/city/backstreets_room)
"R" = (
/turf/open/floor/holofloor/dark,
/area/city/backstreets_room)
"T" = (
/mob/living/simple_animal/hostile/ordeal/green_bot{
	name = "guard bot"
	},
/turf/open/floor/holofloor/dark,
/area/city/backstreets_room)
"V" = (
/obj/effect/decal/fakelattice,
/turf/open/lava/smooth,
/area/city/backstreets_room)
"W" = (
/obj/structure/lattice/catwalk,
/obj/structure/lattice/catwalk,
/turf/open/lava/smooth,
/area/city/backstreets_room)
"X" = (
/obj/structure/chair/sofa/corp/right{
	dir = 1
	},
/obj/effect/decal/cleanable/dirt/dust,
/turf/open/floor/holofloor/dark,
/area/city/backstreets_room)
"Y" = (
/obj/effect/decal/cleanable/dirt,
/obj/item/folder/blue{
	desc = "Appears to be permits and documents of an unspecified workshop.";
	name = "Workshop Folder"
	},
/turf/open/floor/holofloor/dark,
/area/city/backstreets_room)
"Z" = (
/obj/effect/turf_decal/siding/thinplating{
	dir = 4
	},
/obj/item/chair,
/turf/open/floor/carpet/black,
/area/city/backstreets_room)

(1,1,1) = {"
L
L
L
L
L
L
L
L
"}
(2,1,1) = {"
L
a
r
r
r
r
r
L
"}
(3,1,1) = {"
L
V
o
x
F
I
r
L
"}
(4,1,1) = {"
L
V
e
R
u
Q
r
L
"}
(5,1,1) = {"
L
V
b
K
K
O
r
L
"}
(6,1,1) = {"
L
r
r
r
r
r
W
L
"}
(7,1,1) = {"
L
L
L
L
L
z
L
L
"}
(8,1,1) = {"
L
P
v
f
j
w
g
L
"}
(9,1,1) = {"
L
B
R
R
R
D
Y
L
"}
(10,1,1) = {"
L
m
w
l
d
s
t
L
"}
(11,1,1) = {"
L
L
n
L
L
L
L
L
"}
(12,1,1) = {"
L
i
y
R
A
y
M
L
"}
(13,1,1) = {"
n
R
C
H
h
q
G
L
"}
(14,1,1) = {"
n
R
J
N
Z
E
X
L
"}
(15,1,1) = {"
L
y
T
R
R
T
p
L
"}
(16,1,1) = {"
L
c
c
c
c
c
c
L
"}
